Rank,Release,Opening_Rev,Total_Gross,Non_opening_rev,% of Total,Theaters,Average_Theatre_Rev,Date,Distributor
1,Avengers: Endgame,357115007,858373000,501257993,41.60,"4,662",76601,"Apr 26, 2019",Walt Disney Studios Motion Pictures
2,Avengers: Infinity War,257698183,678815482,421117299,38,"4,474",57599,"Apr 27, 2018",Walt Disney Studios Motion Pictures
3,Star Wars: Episode VII - The Force Awakens,247966675,936662225,688695550,26.50,"4,134",59982,"Dec 18, 2015",Walt Disney Studios Motion Pictures
4,Star Wars: Episode VIII - The Last Jedi,220009584,620181382,400171798,35.50,"4,232",51987,"Dec 15, 2017",Walt Disney Studios Motion Pictures
5,Jurassic World,208806270,652270625,443464355,32,"4,274",48855,"Jun 12, 2015",Universal Pictures
6,The Avengers,207438708,623357910,415919202,33.30,"4,349",47698,"May 4, 2012",Walt Disney Studios Motion Pictures
7,Black Panther,202003951,700059566,498055615,28.90,"4,020",50249,"Feb 16, 2018",Walt Disney Studios Motion Pictures
8,The Lion King,191770759,543638043,351867284,35.30,"4,725",40586,"Jul 19, 2019",Walt Disney Studios Motion Pictures
9,Avengers: Age of Ultron,191271109,459005868,267734759,41.70,"4,276",44731,"May 1, 2015",Walt Disney Studios Motion Pictures
10,Incredibles 2,182687905,608581744,425893839,30,"4,410",41425,"Jun 15, 2018",Walt Disney Studios Motion Pictures
11,Captain America: Civil War,179139142,408084349,228945207,43.90,"4,226",42389,"May 6, 2016",Walt Disney Studios Motion Pictures
12,Star Wars: Episode IX - The Rise of Skywalker,177383864,515049789,337665925,34.40,"4,406",40259,"Dec 20, 2019",Walt Disney Studios Motion Pictures
13,Beauty and the Beast,174750616,504014165,329263549,34.70,"4,210",41508,"Mar 17, 2017",Walt Disney Studios Motion Pictures
14,Iron Man 3,174144585,409013994,234869409,42.60,"4,253",40946,"May 3, 2013",Walt Disney Studios Motion Pictures
15,Harry Potter and the Deathly Hallows: Part 2,169189427,381011219,211821792,44.40,"4,375",38671,"Jul 15, 2011",Warner Bros.
16,Batman v Superman: Dawn of Justice,166007347,330360194,164352847,50.20,"4,242",39134,"Mar 25, 2016",Warner Bros.
17,The Dark Knight Rises,160887295,448139099,287251804,35.90,"4,404",36532,"Jul 20, 2012",Warner Bros.
18,The Dark Knight,158411483,533345358,374933875,29.70,"4,366",36282,"Jul 18, 2008",Warner Bros.
19,The Hunger Games: Catching Fire,158074286,424668047,266593761,37.20,"4,163",37971,"Nov 22, 2013",Lionsgate
20,Rogue One: A Star Wars Story,155081681,532177324,377095643,29.10,"4,157",37306,"Dec 16, 2016",Walt Disney Studios Motion Pictures
21,Captain Marvel,153433423,426829839,273396416,36,"4,310",35599,"Mar 8, 2019",Walt Disney Studios Motion Pictures
22,The Hunger Games,152535747,408010692,255474945,37.40,"4,137",36871,"Mar 23, 2012",Lionsgate
23,Spider-Man 3,151116516,336530303,185413787,44.90,"4,252",35540,"May 4, 2007",Sony Pictures Releasing
24,Jurassic World: Fallen Kingdom,148024610,417719760,269695150,35.40,"4,475",33078,"Jun 22, 2018",Universal Pictures
25,Furious 7,147187040,353007020,205819980,41.70,"4,004",36760,"Apr 3, 2015",Universal Pictures
26,Guardians of the Galaxy Vol. 2,146510104,389813101,243302997,37.60,"4,347",33703,"May 5, 2017",Walt Disney Studios Motion Pictures
27,The Twilight Saga: New Moon,142839137,296623634,153784497,48.20,"4,024",35496,"Nov 20, 2009",Summit Entertainment
28,The Twilight Saga: Breaking Dawn - Part 2,141067634,292324737,151257103,48.30,"4,070",34660,"Nov 16, 2012",Lionsgate
29,The Twilight Saga: Breaking Dawn - Part 1,138122261,281287133,143164872,49.10,"4,061",34011,"Nov 18, 2011",Summit Entertainment
30,Pirates of the Caribbean: Dead Man's Chest,135634554,423315812,287681258,32,"4,133",32817,"Jul 7, 2006",Walt Disney Studios Motion Pictures
31,Finding Dory,135060273,486295561,351235288,27.80,"4,305",31372,"Jun 17, 2016",Walt Disney Studios Motion Pictures
32,Suicide Squad,133682248,325100054,191417806,41.10,"4,255",31417,"Aug 5, 2016",Warner Bros.
33,Deadpool,132434639,363070709,230636070,36.50,"3,558",37221,"Feb 12, 2016",Twentieth Century Fox
34,Frozen II,130263358,477284992,347021634,27.30,"4,440",29338,"Nov 22, 2019",Walt Disney Studios Motion Pictures
35,Iron Man 2,128122480,312433331,184310851,41,"4,380",29251,"May 7, 2010",Paramount Pictures
36,Deadpool 2,125507153,318491426,192984273,39.40,"4,349",28858,"May 18, 2018",Twentieth Century Fox
37,Harry Potter and the Deathly Hallows: Part 1,125017372,295983305,170965933,42.20,"4,125",30307,"Nov 19, 2010",Warner Bros.
38,It,123403419,327481748,204078329,37.70,"4,103",30076,"Sep 8, 2017",Warner Bros.
39,Thor: Ragnarok,122744989,315058289,192313300,39,"4,080",30084,"Nov 3, 2017",Walt Disney Studios Motion Pictures
40,The Hunger Games: Mockingjay - Part 1,121897634,337135885,215238251,36.20,"4,151",29365,"Nov 21, 2014",Lionsgate
41,Shrek the Third,121629270,322719944,201090674,37.70,"4,122",29507,"May 18, 2007",DreamWorks
42,Toy Story 4,120908065,434038008,313129943,27.90,"4,575",26427,"Jun 21, 2019",Walt Disney Studios Motion Pictures
43,Spider-Man: Homecoming,117027503,334201140,217173637,35,"4,348",26915,"Jul 7, 2017",Sony Pictures Releasing
44,Man of Steel,116619362,291045518,174426156,40.10,"4,207",27720,"Jun 14, 2013",Warner Bros.
45,Alice in Wonderland,116101023,334191110,218090087,34.70,"3,728",31142,"Mar 5, 2010",Walt Disney Studios Motion Pictures
46,Minions,115718405,336045770,220327365,34.40,"4,301",26905,"Jul 10, 2015",Universal Pictures
47,Spider-Man,114844116,403706375,288862259,28.40,"3,615",31768,"May 3, 2002",Sony Pictures Releasing
48,Pirates of the Caribbean: At World's End,114732820,309420425,194687605,37.10,"4,362",26302,"May 25, 2007",Walt Disney Studios Motion Pictures
49,Toy Story 3,110307189,415004880,304697691,26.60,"4,028",27385,"Jun 18, 2010",Walt Disney Studios Motion Pictures
50,Transformers: Revenge of the Fallen,108966307,402111870,293145563,27.10,"4,234",25736,"Jun 24, 2009",DreamWorks
51,Star Wars: Episode III - Revenge of the Sith,108435841,380270577,271834736,28.50,"3,661",29619,"May 19, 2005",Twentieth Century Fox
52,Shrek 2,108037878,441226247,333188369,24.50,"4,163",25951,"May 19, 2004",DreamWorks Distribution
53,The Secret Life of Pets,104352905,368384330,264031425,28.30,"4,370",23879,"Jul 8, 2016",Universal Pictures
54,The Jungle Book,103261464,364001123,260739659,28.40,"4,028",25635,"Apr 15, 2016",Walt Disney Studios Motion Pictures
55,Wonder Woman,103251471,412563408,309311937,25,"4,165",24790,"Jun 2, 2017",Warner Bros.
56,X-Men: The Last Stand,102750665,234362462,131611797,43.80,"3,690",27845,"May 26, 2006",Twentieth Century Fox
57,Harry Potter and the Goblet of Fire,102685961,290013036,187327075,35.40,"3,858",26616,"Nov 18, 2005",Warner Bros.
58,The Hunger Games: Mockingjay - Part 2,102665981,281723902,179057921,36.40,"4,175",24590,"Nov 20, 2015",Lionsgate
59,Indiana Jones and the Kingdom of the Crystal Skull,100137835,317101119,216963284,31.60,"4,260",23506,"May 22, 2008",Paramount Pictures
60,Transformers: Age of Extinction,100038390,245439076,145400686,40.80,"4,233",23632,"Jun 27, 2014",Paramount Pictures
61,The Fate of the Furious,98786705,226008385,127221680,43.70,"4,310",22920,"Apr 14, 2017",Universal Pictures
62,Iron Man,98618668,318604126,219985458,31,"4,105",24024,"May 2, 2008",Paramount Pictures
63,Transformers: Dark of the Moon,97852865,352390543,254537678,27.80,"4,088",23936,"Jun 29, 2011",DreamWorks
64,Fast & Furious 6,97375245,238679850,141304605,40.80,"3,658",26619,"May 24, 2013",Universal Pictures
65,Joker,96202337,335451311,239248974,28.70,"4,374",21994,"Oct 4, 2019",Warner Bros.
66,Captain America: The Winter Soldier,95023721,259766572,164742851,36.60,"3,938",24129,"Apr 4, 2014",Walt Disney Studios Motion Pictures
67,Guardians of the Galaxy,94320883,333176600,238855717,28.30,"4,080",23117,"Aug 1, 2014",Walt Disney Studios Motion Pictures
68,Justice League,93842239,229024295,135182056,41,"4,051",23165,"Nov 17, 2017",Warner Bros.
69,Harry Potter and the Prisoner of Azkaban,93687367,249541069,155853702,37.50,"3,855",24302,"Jun 4, 2004",Warner Bros.
70,Godzilla,93188384,200676069,107487685,46.40,"3,952",23580,"May 16, 2014",Warner Bros.
71,Spider-Man: Far from Home,92579212,390532085,297952873,23.70,"4,634",19978,"Jul 2, 2019",Sony Pictures Releasing
72,The Matrix Reloaded,91774413,281576461,189802048,32.60,"3,603",25471,"May 15, 2003",Warner Bros.
73,The Amazing Spider-Man 2,91608337,202853933,111245596,45.20,"4,324",21186,"May 2, 2014",Sony Pictures Releasing
74,Aladdin,91500929,355559216,264058287,25.70,"4,476",20442,"May 24, 2019",Walt Disney Studios Motion Pictures
75,It Chapter Two,91062152,211593228,120531076,43,"4,570",19926,"Sep 6, 2019",Warner Bros.
76,X-Men: Days of Future Past,90823660,233921534,143097874,38.80,"3,996",22728,"May 23, 2014",Twentieth Century Fox
77,Inside Out,90440272,356461711,266021439,25.40,"3,946",22919,"Jun 19, 2015",Walt Disney Studios Motion Pictures
78,Harry Potter and the Sorcerer's Stone,90294621,317575550,227280929,28.40,"3,672",24590,"Nov 16, 2001",Warner Bros.
79,Pirates of the Caribbean: On Stranger Tides,90151958,241071802,150919844,37.40,"4,155",21697,"May 20, 2011",Walt Disney Studios Motion Pictures
80,Logan,88411916,226277068,137865152,39.10,"4,071",21717,"Mar 3, 2017",Twentieth Century Fox
81,Skyfall,88364714,304360277,215995563,29,"3,505",25211,"Nov 9, 2012",Sony Pictures Releasing
82,Harry Potter and the Chamber of Secrets,88357488,261988482,173630994,33.70,"3,682",23997,"Nov 15, 2002",Warner Bros.
83,Spider-Man 2,88156227,373585825,285429598,23.60,"4,152",21232,"Jun 30, 2004",Sony Pictures Releasing
84,Fast Five,86198765,209837675,123638910,41.10,"3,644",23654,"Apr 29, 2011",Universal Pictures
85,The Hangover Part II,85946294,254464305,168518011,33.80,"3,615",23774,"May 26, 2011",Warner Bros.
86,Thor: The Dark World,85737841,206362140,120624299,41.60,"3,841",22321,"Nov 8, 2013",Walt Disney Studios Motion Pictures
87,X2: X-Men United,85558731,214949694,129390963,39.80,"3,741",22870,"May 2, 2003",Twentieth Century Fox
88,Fifty Shades of Grey,85171450,166167230,80995780,51.30,"3,646",23360,"Feb 13, 2015",Universal Pictures
89,Doctor Strange,85058311,232641920,147583609,36.60,"3,882",21910,"Nov 4, 2016",Walt Disney Studios Motion Pictures
90,X-Men Origins: Wolverine,85058003,179883157,94825154,47.30,"4,099",20750,"May 1, 2009",Twentieth Century Fox
91,The Hobbit: An Unexpected Journey,84617303,303003568,218386265,27.90,"4,045",20918,"Dec 14, 2012",Warner Bros.
92,Solo: A Star Wars Story,84420489,213767512,129347023,39.50,"4,381",19269,"May 25, 2018",Walt Disney Studios Motion Pictures
93,The Passion of the Christ,83848082,370274604,286426522,22.60,"3,043",27554,"Feb 25, 2004",Newmarket Films
94,Despicable Me 2,83517315,368065385,284548070,22.70,"3,997",20895,"Jul 3, 2013",Universal Pictures
95,Monsters University,82429469,268492764,186063295,30.70,"4,004",20586,"Jun 21, 2013",Walt Disney Studios Motion Pictures
96,Venom,80255756,213515506,133259750,37.60,"4,250",18883,"Oct 5, 2018",Sony Pictures Releasing
97,Star Wars: Episode II - Attack of the Clones,80027814,302191252,222163438,26.50,"3,161",25317,"May 16, 2002",Twentieth Century Fox
98,Oz the Great and Powerful,79110453,234911825,155801372,33.70,"3,912",20222,"Mar 8, 2013",Walt Disney Studios Motion Pictures
99,Harry Potter and the Half-Blood Prince,77835727,301959197,224123470,25.80,"4,325",17996,"Jul 15, 2009",Warner Bros.
100,I Am Legend,77211321,256393010,179181689,30.10,"3,606",21411,"Dec 14, 2007",Warner Bros.
101,Harry Potter and the Order of the Phoenix,77108414,292004738,214896324,26.40,"4,285",17994,"Jul 11, 2007",Warner Bros.
102,The Da Vinci Code,77073388,217536138,140462750,35.40,"3,735",20635,"May 19, 2006",Sony Pictures Releasing
103,Avatar,77025481,749766139,672740658,10.30,"3,452",22313,"Dec 18, 2009",Twentieth Century Fox
104,Halloween,76221545,159342015,83120470,47.80,"3,928",19404,"Oct 19, 2018",Universal Pictures
105,Ant-Man and the Wasp,75812205,216648740,140836535,35,"4,206",18024,"Jul 6, 2018",Walt Disney Studios Motion Pictures
106,Star Trek,75204289,257730019,182525730,29.20,"3,849",19538,"May 8, 2009",Paramount Pictures
107,Zootopia,75063401,341268248,266204847,22,"3,827",19614,"Mar 4, 2016",Walt Disney Studios Motion Pictures
108,Fantastic Beasts and Where to Find Them,74403387,234037575,159634188,31.80,"4,144",17954,"Nov 18, 2016",Warner Bros.
109,The Simpsons Movie,74036787,183135014,109098227,40.40,"3,922",18877,"Jul 27, 2007",Twentieth Century Fox
110,The Hobbit: The Desolation of Smaug,73645197,258366855,184721658,28.50,"3,903",18868,"Dec 13, 2013",Warner Bros.
111,Austin Powers in Goldmember,73071188,213307889,140236701,34.30,"3,613",20224,"Jul 26, 2002",New Line Cinema
112,The Lord of the Rings: The Return of the King,72629713,377027325,304397612,19.30,"3,703",19613,"Dec 17, 2003",New Line Cinema
113,Dawn of the Planet of the Apes,72611427,208545589,135934162,34.80,"3,967",18303,"Jul 11, 2014",Twentieth Century Fox
114,Despicable Me 3,72434025,264624300,192190275,27.40,"4,529",15993,"Jun 30, 2017",Universal Pictures
115,The Lost World: Jurassic Park,72132785,229086679,156953894,31.50,"3,281",21985,"May 23, 1997",Universal Pictures
116,Us,71117625,175084580,103966955,40.60,"3,741",19010,"Mar 22, 2019",Universal Pictures
117,Fast & Furious,70950500,155064265,84113765,45.80,"3,461",20500,"Apr 3, 2009",Universal Pictures
118,300,70885301,210614939,139729638,33.70,"3,103",22844,"Mar 9, 2007",Warner Bros.
119,Shrek Forever After,70838207,238736787,167898580,29.70,"4,359",16251,"May 21, 2010",DreamWorks
120,Transformers,70502384,319246193,248743809,22.10,"4,011",17577,"Jul 3, 2007",DreamWorks
121,The Incredibles,70467623,261441092,190973469,27,"3,933",17917,"Nov 5, 2004",Walt Disney Studios Motion Pictures
122,Spectre,70403148,200074609,129671461,35.20,"3,929",17918,"Nov 6, 2015",Sony Pictures Releasing
123,Finding Nemo,70251710,339714978,269463268,20.70,"3,374",20821,"May 30, 2003",Walt Disney Studios Motion Pictures
124,The Lorax,70217070,214030500,143813430,32.80,"3,729",18830,"Mar 2, 2012",Universal Pictures
125,Star Trek Into Darkness,70165559,228778661,158613102,30.70,"3,868",18140,"May 16, 2013",Paramount Pictures
126,Twilight,69637740,192769854,123132114,36.10,"3,419",20367,"Nov 21, 2008",Summit Entertainment
127,Maleficent,69431298,241410378,171979080,28.80,"3,948",17586,"May 30, 2014",Walt Disney Studios Motion Pictures
128,The Bourne Ultimatum,69283690,227471070,158187380,30.50,"3,660",18929,"Aug 3, 2007",Universal Pictures
129,Pitch Perfect 2,69216890,184296230,115079340,37.60,"3,473",19930,"May 15, 2015",Universal Pictures
130,The Lego Movie,69050279,257760692,188710413,26.80,"3,775",18291,"Feb 7, 2014",Warner Bros.
131,The Day After Tomorrow,68743584,186740799,117997215,36.80,"3,425",20071,"May 28, 2004",Twentieth Century Fox
132,Planet of the Apes,68532960,180011740,111478780,38.10,"3,500",19580,"Jul 27, 2001",Twentieth Century Fox
133,The Mummy Returns,68139035,202019785,133880750,33.70,"3,401",20035,"May 4, 2001",Universal Pictures
134,Up,68108790,293004164,224895374,23.20,"3,766",18085,"May 29, 2009",Walt Disney Studios Motion Pictures
135,Ice Age: The Meltdown,68033544,195330621,127297077,34.80,"3,964",17162,"Mar 31, 2006",Twentieth Century Fox
136,Bruce Almighty,67953330,242829261,174875931,28,"3,483",19510,"May 23, 2003",Universal Pictures
137,Cinderella,67877361,201151353,133273992,33.70,"3,845",17653,"Mar 13, 2015",Walt Disney Studios Motion Pictures
138,Aquaman,67873522,335061807,267188285,20.30,"4,125",16454,"Dec 21, 2018",Warner Bros.
139,Dr. Seuss' The Grinch,67572855,270620950,203048095,25,"4,141",16318,"Nov 9, 2018",Universal Pictures
140,Quantum of Solace,67528882,168368427,100839545,40.10,"3,451",19567,"Nov 14, 2008",Sony Pictures Releasing
141,Rush Hour 2,67408222,226164286,158756064,29.80,"3,118",21619,"Aug 3, 2001",New Line Cinema
142,World War Z,66411834,202359711,135947877,32.80,"3,607",18411,"Jun 21, 2013",Paramount Pictures
143,Brave,66323594,237283207,170959613,28,"4,164",15927,"Jun 22, 2012",Walt Disney Studios Motion Pictures
144,Cars 2,66135507,191452396,125316889,34.50,"4,115",16071,"Jun 24, 2011",Walt Disney Studios Motion Pictures
145,X-Men: Apocalypse,65769562,155442489,89672927,42.30,"4,150",15848,"May 27, 2016",Twentieth Century Fox
146,Thor,65723338,181030624,115307286,36.30,"3,955",16617,"May 6, 2011",Paramount Pictures
147,Teenage Mutant Ninja Turtles,65575105,191204754,125629649,34.30,"3,845",17054,"Aug 8, 2014",Paramount Pictures
148,"The Chronicles of Narnia: The Lion, the Witch and the Wardrobe",65556312,291710957,226154645,22.50,"3,616",18129,"Dec 9, 2005",Walt Disney Studios Motion Pictures
149,2012,65237614,166112167,100874553,39.30,"3,404",19164,"Nov 13, 2009",Sony Pictures Releasing
150,Captain America: The First Avenger,65058524,176654505,111595981,36.80,"3,715",17512,"Jul 22, 2011",Paramount Pictures
151,War of the Worlds,64878725,234280354,169401629,27.70,"3,908",16601,"Jun 29, 2005",Paramount Pictures
152,The Twilight Saga: Eclipse,64832191,300531751,235699560,21.60,"4,468",14510,"Jun 30, 2010",Summit Entertainment
153,Star Wars: Episode I - The Phantom Menace,64820970,431088295,366267325,15,"2,970",21825,"May 19, 1999",Twentieth Century Fox
154,Madagascar: Escape 2 Africa,63106589,180010950,116904361,35.10,"4,056",15558,"Nov 7, 2008",DreamWorks
155,WALL·E,63087526,223808164,160720638,28.20,"3,992",15803,"Jun 27, 2008",Walt Disney Studios Motion Pictures
156,Pirates of the Caribbean: Dead Men Tell No Tales,62983253,172558876,109575623,36.50,"4,276",14729,"May 26, 2017",Walt Disney Studios Motion Pictures
157,Inception,62785337,292576195,229790858,21.50,"3,792",16557,"Jul 16, 2010",Warner Bros.
158,Hancock,62603879,227946274,165342395,27.50,"3,965",15789,"Jul 2, 2008",Sony Pictures Releasing
159,"Monsters, Inc.",62577067,255873250,193296183,24.50,"3,237",19331,"Nov 2, 2001",Walt Disney Studios Motion Pictures
160,Bad Boys for Life,62504105,202287687,139783582,30.90,"3,775",16557,"Jan 17, 2020",Sony Pictures Releasing
161,Sherlock Holmes,62304277,209028679,146724402,29.80,"3,626",17182,"Dec 25, 2009",Warner Bros.
162,Fantastic Beasts: The Crimes of Grindelwald,62163104,159555901,97392797,39,"4,163",14932,"Nov 16, 2018",Warner Bros.
163,Hulk,62128420,132177234,70048814,47,"3,660",16974,"Jun 20, 2003",Universal Pictures
164,The Lord of the Rings: The Two Towers,62007528,339789881,277782353,18.20,"3,622",17119,"Dec 18, 2002",New Line Cinema
165,The Amazing Spider-Man,62004688,262030663,200025975,23.70,"4,318",14359,"Jul 3, 2012",Sony Pictures Releasing
166,Mission: Impossible - Fallout,61236534,220159104,158922570,27.80,"4,386",13961,"Jul 27, 2018",Paramount Pictures
167,Clash of the Titans,61235105,163214888,101979783,37.50,"3,777",16212,"Apr 2, 2010",Warner Bros.
168,Kong: Skull Island,61025472,168052812,107027340,36.30,"3,846",15867,"Mar 10, 2017",Warner Bros.
169,Madagascar 3: Europe's Most Wanted,60316738,216391482,156074744,27.90,"4,258",14165,"Jun 8, 2012",DreamWorks
170,Kung Fu Panda,60239130,215434591,155195461,28,"4,114",14642,"Jun 6, 2008",DreamWorks
171,Straight Outta Compton,60200180,161197785,100997605,37.40,"2,757",21835,"Aug 14, 2015",Universal Pictures
172,Cars,60119509,244082982,183963473,24.60,"3,985",15086,"Jun 9, 2006",Walt Disney Studios Motion Pictures
173,Signs,60117080,227966634,167849554,26.40,"3,264",18418,"Aug 2, 2002",Walt Disney Studios Motion Pictures
174,Fast & Furious Presents: Hobbs & Shaw,60038950,173956935,113917985,34.50,"4,253",14116,"Aug 2, 2019",Universal Pictures
175,Monsters vs. Aliens,59321095,198351526,139030431,29.90,"4,104",14454,"Mar 27, 2009",DreamWorks
176,Star Trek Beyond,59253211,158848340,99595129,37.30,"3,928",15084,"Jul 22, 2016",Paramount Pictures
177,Jumanji: The Next Level,59251543,315971726,256720183,18.80,"4,227",14017,"Dec 13, 2019",Sony Pictures Releasing
178,Jason Bourne,59215365,162434410,103219045,36.40,"4,026",14708,"Jul 29, 2016",Universal Pictures
179,Pearl Harbor,59078912,198542554,139463642,29.80,"3,214",18381,"May 25, 2001",Walt Disney Studios Motion Pictures
180,Fantastic 4: Rise of the Silver Surfer,58051684,131921738,73870054,44,"3,959",14663,"Jun 15, 2007",Twentieth Century Fox
181,Sonic the Hedgehog,58018348,141140061,83121713,41.10,"4,167",13923,"Feb 14, 2020",Paramount Pictures
182,Hannibal,58003121,165092268,107089147,35.10,"3,230",17957,"Feb 9, 2001",Metro-Goldwyn-Mayer (MGM)
183,Mission: Impossible II,57845297,215409889,157564592,26.80,"3,653",15835,"May 24, 2000",Paramount Pictures
184,Ant-Man,57225526,180202163,122976637,31.80,"3,856",14840,"Jul 17, 2015",Walt Disney Studios Motion Pictures
185,22 Jump Street,57071445,191719337,134647892,29.80,"3,306",17262,"Jun 13, 2014",Sony Pictures Releasing
186,Sex and the City,57038404,152647258,95608854,37.40,"3,285",17363,"May 30, 2008",Warner Bros.
187,John Wick: Chapter 3 - Parabellum,56818067,171015687,114197620,33.20,"3,850",14757,"May 17, 2019",Lionsgate
188,Moana,56631401,248757044,192125643,22.80,"3,875",14614,"Nov 23, 2016",Walt Disney Studios Motion Pictures
189,Despicable Me,56397125,251513985,195116860,22.40,"3,476",16224,"Jul 9, 2010",Universal Pictures
190,War for the Planet of the Apes,56262929,146880162,90617233,38.30,"4,022",13988,"Jul 14, 2017",Twentieth Century Fox
191,Valentine's Day,56260707,110485654,54224947,50.90,"3,665",15350,"Feb 12, 2010",Warner Bros.
192,Ralph Breaks the Internet,56237634,201091711,144854077,28,"4,017",13999,"Nov 21, 2018",Walt Disney Studios Motion Pictures
193,Snow White and the Huntsman,56217700,155332381,99114681,36.20,"3,773",14900,"Jun 1, 2012",Universal Pictures
194,Big Hero 6,56215889,222527828,166311939,25.30,"3,761",14947,"Nov 7, 2014",Walt Disney Studios Motion Pictures
195,Charlie and the Chocolate Factory,56178450,206459076,150280626,27.20,"3,770",14901,"Jul 15, 2005",Warner Bros.
196,Fantastic Four,56061504,154696080,98634576,36.20,"3,602",15563,"Jul 8, 2005",Twentieth Century Fox
197,Gravity,55785112,274092705,218307593,20.40,"3,575",15604,"Oct 4, 2013",Warner Bros.
198,The Karate Kid,55665805,176591618,120925813,31.50,"3,663",15196,"Jun 11, 2010",Sony Pictures Releasing
199,Mission: Impossible - Rogue Nation,55520089,195042377,139522288,28.50,"3,956",14034,"Jul 31, 2015",Paramount Pictures
200,The Incredible Hulk,55414050,134806913,79392863,41.10,"3,505",15810,"Jun 13, 2008",Universal Pictures
201,The SpongeBob Movie: Sponge Out of Water,55365012,162994032,107629020,34,"3,641",15205,"Feb 6, 2015",Paramount Pictures
202,Watchmen,55214334,107509799,52295465,51.40,"3,611",15290,"Mar 6, 2009",Warner Bros.
203,X-Men: First Class,55101604,146408305,91306701,37.60,"3,641",15133,"Jun 3, 2011",Twentieth Century Fox
204,How the Grinch Stole Christmas,55082330,260044825,204962495,21.20,"3,127",17615,"Nov 17, 2000",Universal Pictures
205,The Chronicles of Narnia: Prince Caspian,55034805,141621490,86586685,38.90,"3,929",14007,"May 16, 2008",Walt Disney Studios Motion Pictures
206,How to Train Your Dragon: The Hidden World,55022245,160799505,105777260,34.20,"4,259",12919,"Feb 22, 2019",Universal Pictures
207,Rise of the Planet of the Apes,54806191,176760185,121953994,31,"3,648",15023,"Aug 5, 2011",Twentieth Century Fox
208,The Hobbit: The Battle of the Five Armies,54724334,255119788,200395454,21.40,"3,875",14122,"Dec 17, 2014",Warner Bros.
209,G.I. Joe: The Rise of Cobra,54713046,150201498,95488452,36.40,"4,007",13654,"Aug 7, 2009",Paramount Pictures
210,Divergent,54607747,150947895,96340148,36.20,"3,936",13873,"Mar 21, 2014",Lionsgate
211,Men in Black 3,54592779,179020854,124428075,30.50,"4,248",12851,"May 25, 2012",Sony Pictures Releasing
212,San Andreas,54588173,155190832,100602659,35.20,"3,777",14452,"May 29, 2015",Warner Bros.
213,X-Men,54471475,157299718,102828243,34.60,"3,025",18007,"Jul 14, 2000",Twentieth Century Fox
214,Ted,54415205,218815487,164400282,24.90,"3,239",16800,"Jun 29, 2012",Universal Pictures
215,Pokémon Detective Pikachu,54365242,144105346,89740104,37.70,"4,202",12937,"May 10, 2019",Warner Bros.
216,The Martian,54308575,228433663,174125088,23.80,"3,831",14176,"Oct 2, 2015",Twentieth Century Fox
217,Night at the Museum: Battle of the Smithsonian,54173286,177243721,123070435,30.60,"4,096",13225,"May 22, 2009",Twentieth Century Fox
218,Scooby-Doo,54155312,153294164,99138852,35.30,"3,447",15710,"Jun 14, 2002",Warner Bros.
219,The Nun,53807379,117450119,63642740,45.80,"3,876",13882,"Sep 7, 2018",Warner Bros.
220,Cars 3,53688680,152901115,99212435,35.10,"4,256",12614,"Jun 16, 2017",Walt Disney Studios Motion Pictures
221,Shazam!,53505326,140371656,86866330,38.10,"4,217",12688,"Apr 5, 2019",Warner Bros.
222,Green Lantern,53174303,116601172,63426869,45.60,"3,816",13934,"Jun 17, 2011",Warner Bros.
223,The Wolverine,53113752,132556852,79443100,40.10,"3,924",13535,"Jul 26, 2013",Twentieth Century Fox
224,The Lego Batman Movie,53003468,175750384,122746916,30.20,"4,088",12965,"Feb 10, 2017",Warner Bros.
225,Batman Forever,52784433,184031112,131246679,28.70,"2,842",18572,"Jun 16, 1995",Warner Bros.
226,Paranormal Activity 3,52568183,104028807,51460624,50.50,"3,321",15829,"Oct 21, 2011",Paramount Pictures
227,Superman Returns,52535096,200081192,147546096,26.30,"4,065",12923,"Jun 28, 2006",Warner Bros.
228,The Bourne Supremacy,52521865,176241941,123720076,29.80,"3,165",16594,"Jul 23, 2004",Universal Pictures
229,Insurgent,52263680,130179072,77915392,40.20,"3,875",13487,"Mar 20, 2015",Lionsgate
230,"I, Robot",52179887,144801023,92621136,36,"3,420",15257,"Jul 16, 2004",Twentieth Century Fox
231,Men in Black II,52148751,190418803,138270052,27.40,"3,557",14660,"Jul 3, 2002",Sony Pictures Releasing
232,Home,52107731,177397510,125289779,29.40,"3,708",14052,"Mar 27, 2015",Twentieth Century Fox
233,Van Helsing,51748040,120177084,68429044,43.10,"3,575",14474,"May 7, 2004",Universal Pictures
234,8 Mile,51240555,116750901,65510346,43.90,"2,470",20745,"Nov 8, 2002",Universal Pictures
235,Men in Black,51068455,250690539,199622084,20.40,"3,020",16910,"Jul 2, 1997",Sony Pictures Releasing
236,Bohemian Rhapsody,51061119,216428042,165366923,23.60,"4,000",12765,"Nov 2, 2018",Twentieth Century Fox
237,Prometheus,51050101,126477084,75426983,40.40,"3,396",15032,"Jun 8, 2012",Twentieth Century Fox
238,Wanted,50927085,134508551,83581466,37.90,"3,175",16040,"Jun 27, 2008",Universal Pictures
239,Coco,50802605,209726015,158923410,24.20,"3,987",12742,"Nov 22, 2017",Walt Disney Studios Motion Pictures
240,Jurassic Park III,50771645,181171875,130400230,28,"3,434",14784,"Jul 18, 2001",Universal Pictures
241,The Village,50746142,114197520,63451378,44.40,"3,730",13604,"Jul 30, 2004",Walt Disney Studios Motion Pictures
242,Dunkirk,50513488,188045546,137532058,26.90,"3,720",13578,"Jul 21, 2017",Warner Bros.
243,2 Fast 2 Furious,50472480,127154901,76682421,39.70,"3,408",14810,"Jun 6, 2003",Universal Pictures
244,Jackass 3D,50353641,117229692,66876051,43,"3,081",16343,"Oct 15, 2010",Paramount Pictures
245,Mr. & Mrs. Smith,50342878,186336279,135993401,27,"3,424",14702,"Jun 10, 2005",Twentieth Century Fox
246,Rush Hour 3,50237000,140125968,89888968,35.80,"3,778",13297,"Aug 10, 2007",New Line Cinema
247,Independence Day,50228264,306169268,255941004,16.40,"2,882",17428,"Jul 3, 1996",Twentieth Century Fox
248,A Quiet Place,50203562,188024361,137820799,26.70,"3,508",14311,"Apr 6, 2018",Paramount Pictures
249,The Boss Baby,50198902,175003033,124804131,28.70,"3,773",13304,"Mar 31, 2017",Twentieth Century Fox
250,King Kong,50130145,218080025,167949880,23,"3,568",14049,"Dec 14, 2005",Universal Pictures
251,The Great Gatsby,50085185,144840419,94755234,34.60,"3,535",14168,"May 10, 2013",Warner Bros.
252,Scary Movie 3,49700000,110003217,60303217,45.20,"3,505",14179,"Oct 24, 2003",Dimension Films
253,Taken 2,49514769,139854287,90339518,35.40,"3,661",13524,"Oct 5, 2012",Twentieth Century Fox
254,How to Train Your Dragon 2,49451322,177002924,127551602,27.90,"4,253",11627,"Jun 13, 2014",Twentieth Century Fox
255,Wreck-It Ralph,49038712,189422889,140384177,25.90,"3,752",13070,"Nov 2, 2012",Walt Disney Studios Motion Pictures
256,Neighbors,49033915,150157400,101123485,32.70,"3,279",14953,"May 9, 2014",Universal Pictures
257,Alvin and the Chipmunks: The Squeakquel,48875415,219614612,170739197,22.30,"3,700",13209,"Dec 23, 2009",Twentieth Century Fox
258,Tangled,48767052,200821936,152054884,24.30,"3,603",13535,"Nov 24, 2010",Walt Disney Studios Motion Pictures
259,Batman Begins,48745440,205343774,156598334,23.70,"3,858",12634,"Jun 15, 2005",Warner Bros.
260,The Matrix Revolutions,48475154,139313948,90838794,34.80,"3,502",13842,"Nov 5, 2003",Warner Bros.
261,Hotel Transylvania 2,48464322,169700110,121235788,28.60,"3,754",12910,"Sep 25, 2015",Sony Pictures Releasing
262,The Fault in Our Stars,48002523,124872350,76869827,38.40,"3,173",15128,"Jun 6, 2014",Twentieth Century Fox
263,Godzilla: King of the Monsters,47776293,110500138,62723845,43.20,"4,108",11630,"May 31, 2019",Warner Bros.
264,Mission: Impossible III,47743273,134029801,86286528,35.60,"4,054",11776,"May 5, 2006",Paramount Pictures
265,Lara Croft: Tomb Raider,47735743,131168070,83432327,36.40,"3,308",14430,"Jun 15, 2001",Paramount Pictures
266,Kung Fu Panda 2,47656302,165249063,117592761,28.80,"3,925",12141,"May 26, 2011",DreamWorks
267,The Longest Yard,47606480,158119460,110512980,30.10,"3,634",13100,"May 27, 2005",Paramount Pictures
268,Shark Tale,47604606,160861908,113257302,29.60,"4,016",11853,"Oct 1, 2004",DreamWorks Distribution
269,Interstellar,47510360,188020017,140509657,25.30,"3,561",13341,"Nov 5, 2014",Paramount Pictures
270,Madagascar,47224594,193595521,146370927,24.40,"4,131",11431,"May 27, 2005",DreamWorks Distribution
271,The Lord of the Rings: The Fellowship of the Ring,47211490,313364114,266152624,15.10,"3,359",14055,"Dec 19, 2001",New Line Cinema
272,Die Another Day,47072040,160942139,113870099,29.20,"3,314",14203,"Nov 22, 2002",Metro-Goldwyn-Mayer (MGM)
273,Talladega Nights: The Ballad of Ricky Bobby,47042215,148213377,101171162,31.70,"3,803",12369,"Aug 4, 2006",Sony Pictures Releasing
274,Ratatouille,47027395,206445654,159418259,22.80,"3,940",11935,"Jun 29, 2007",Walt Disney Studios Motion Pictures
275,Jurassic Park,47026828,357067947,310041119,13.20,"2,404",19561,"Jun 11, 1993",Universal Pictures
276,Troy,46865412,133378256,86512844,35.10,"3,411",13739,"May 14, 2004",Warner Bros.
277,The Secret Life of Pets 2,46652680,158874395,112221715,29.40,"4,561",10228,"Jun 7, 2019",Universal Pictures
278,Pirates of the Caribbean: The Curse of the Black Pearl,46630690,305413918,258783228,15.30,"3,269",14264,"Jul 9, 2003",Walt Disney Studios Motion Pictures
279,Ice Age: Continental Drift,46629259,161321843,114692584,28.90,"3,881",12014,"Jul 13, 2012",Twentieth Century Fox
280,Fifty Shades Darker,46607250,114581250,67974000,40.70,"3,710",12562,"Feb 10, 2017",Universal Pictures
281,Trolls,46581142,153707064,107125922,30.30,"4,060",11473,"Nov 4, 2016",Twentieth Century Fox
282,Bad Boys II,46522560,138608444,92085884,33.60,"3,186",14602,"Jul 18, 2003",Sony Pictures Releasing
283,Ice Age,46312454,176387405,130074951,26.30,"3,316",13966,"Mar 15, 2002",Twentieth Century Fox
284,Angels & Demons,46204168,133375846,87171678,34.60,"3,527",13100,"May 15, 2009",Sony Pictures Releasing
285,Meet the Fockers,46120980,279261160,233140180,16.50,"3,518",13110,"Dec 22, 2004",Universal Pictures
286,Ghostbusters,46018755,128350574,82331819,35.80,"3,963",11612,"Jul 15, 2016",Sony Pictures Releasing
287,Megamind,46016833,148415853,102399020,31,"3,944",11667,"Nov 5, 2010",DreamWorks
288,Dumbo,45990748,114766307,68775559,40.10,"4,259",10798,"Mar 29, 2019",Walt Disney Studios Motion Pictures
289,Batman Returns,45687711,162831698,117143987,28.10,"2,644",17279,"Jun 19, 1992",Warner Bros.
290,Mission: Impossible,45436830,180981856,135545026,25.10,"3,012",15085,"May 22, 1996",Paramount Pictures
291,Mad Max: Fury Road,45428128,153636354,108208226,29.60,"3,702",12271,"May 15, 2015",Warner Bros.
292,The Meg,45402195,145443742,100041547,31.20,"4,118",11025,"Aug 10, 2018",Warner Bros.
293,Ghost Rider,45388836,115802596,70413760,39.20,"3,619",12541,"Feb 16, 2007",Sony Pictures Releasing
294,American Pie 2,45117985,145103595,99985610,31.10,"3,063",14729,"Aug 10, 2001",Universal Pictures
295,300: Rise of an Empire,45038460,106580051,61541591,42.30,"3,470",12979,"Mar 7, 2014",Warner Bros.
296,Horton Hears a Who!,45012998,154529439,109516441,29.10,"3,954",11384,"Mar 14, 2008",Twentieth Century Fox
297,The Hangover,44979319,277322503,232343184,16.20,"3,269",13759,"Jun 5, 2009",Warner Bros.
298,National Treasure: Book of Secrets,44783772,219964115,175180343,20.40,"3,832",11686,"Dec 21, 2007",Walt Disney Studios Motion Pictures
299,Transformers: The Last Knight,44680073,130168683,85488610,34.30,"4,069",10980,"Jun 21, 2017",Paramount Pictures
300,xXx,44506103,142109382,97603279,31.30,"3,374",13190,"Aug 9, 2002",Revolution Studios
301,Alvin and the Chipmunks,44307417,217326974,173019557,20.40,"3,475",12750,"Dec 14, 2007",Twentieth Century Fox
302,The Peanuts Movie,44213073,130178411,85965338,34,"3,897",11345,"Nov 6, 2015",Twentieth Century Fox
303,Hotel Transylvania 3: Summer Vacation,44076225,167510016,123433791,26.30,"4,267",10329,"Jul 13, 2018",Sony Pictures Releasing
304,Godzilla,44047541,136314294,92266753,32.30,"3,310",13307,"May 20, 1998",Sony Pictures Releasing
305,Terminator 3: Rise of the Machines,44041440,150371112,106329672,29.30,"3,504",12568,"Jul 2, 2003",Warner Bros.
306,TRON: Legacy,44026211,172062763,128036552,25.60,"3,451",12757,"Dec 17, 2010",Walt Disney Studios Motion Pictures
307,Lucy,43899340,126663600,82764260,34.70,"3,173",13835,"Jul 25, 2014",Universal Pictures
308,How to Train Your Dragon,43732319,217581231,173848912,20.10,"4,055",10784,"Mar 26, 2010",DreamWorks
309,Noah,43720472,101200044,57479572,43.20,"3,567",12256,"Mar 28, 2014",Paramount Pictures
310,The Croods,43639736,187168425,143528689,23.30,"4,046",10785,"Mar 22, 2013",Twentieth Century Fox
311,American Gangster,43565135,130164645,86599510,33.50,"3,054",14264,"Nov 2, 2007",Universal Pictures
312,The Mummy,43369635,155385488,112015853,27.90,"3,210",13510,"May 7, 1999",Universal Pictures
313,Hitch,43142214,179495555,136353341,24,"3,575",12067,"Feb 11, 2005",Sony Pictures Releasing
314,A Star Is Born,42908051,215288866,172380815,19.90,"3,686",11640,"Oct 5, 2018",Warner Bros.
315,Batman & Robin,42872605,107325195,64452590,40,"2,934",14612,"Jun 20, 1997",Warner Bros.
316,Terminator Salvation,42558390,125322469,82764079,34,"3,530",12056,"May 21, 2009",Warner Bros.
317,Hotel Transylvania,42522194,148313048,105790854,28.70,"3,349",12696,"Sep 28, 2012",Sony Pictures Releasing
318,Nutty Professor II: The Klumps,42518830,123309890,80791060,34.50,"3,242",13115,"Jul 28, 2000",Universal Pictures
319,Shrek,42347760,267665011,225317251,15.80,"3,587",11805,"May 16, 2001",DreamWorks Distribution
320,Scary Movie,42346669,157019771,114673102,27,"2,912",14542,"Jul 7, 2000",Miramax
321,Anger Management,42220847,135645823,93424976,31.10,"3,551",11889,"Apr 11, 2003",Revolution Studios
322,High School Musical 3,42030184,90559416,48529232,46.40,"3,623",11600,"Oct 24, 2008",Walt Disney Studios Motion Pictures
323,The Conjuring,41855326,137400141,95544815,30.50,"2,903",14417,"Jul 19, 2013",Warner Bros.
324,Ready Player One,41764050,137690172,95926122,30.30,"4,234",9863,"Mar 29, 2018",Warner Bros.
325,Ice Age: Dawn of the Dinosaurs,41690382,196573705,154883323,21.20,"4,099",10170,"Jul 1, 2009",Twentieth Century Fox
326,The Hangover Part III,41671198,112200072,70528874,37.10,"3,555",11721,"May 23, 2013",Warner Bros.
327,Ocean's Eight,41607378,140218711,98611333,29.70,"4,145",10037,"Jun 8, 2018",Warner Bros.
328,Big Daddy,41536370,163479795,121943425,25.40,"3,027",13721,"Jun 25, 1999",Sony Pictures Releasing
329,Happy Feet,41533432,198000317,156466885,21,"3,804",10918,"Nov 17, 2006",Warner Bros.
330,Ride Along,41516170,134938200,93422030,30.80,"2,663",15590,"Jan 17, 2014",Universal Pictures
331,Grown Ups 2,41508572,133668525,92159953,31,"3,491",11890,"Jul 12, 2013",Sony Pictures Releasing
332,The Perfect Storm,41325042,182618434,141293392,22.60,"3,407",12129,"Jun 30, 2000",Warner Bros.
333,Kung Fu Panda 3,41282042,143528619,102246577,28.80,"3,955",10437,"Jan 29, 2016",Twentieth Century Fox
334,The Vow,41202458,125014030,83811572,33,"2,958",13929,"Feb 10, 2012",Screen Gems
335,Deep Impact,41152375,140464664,99312289,29.30,"3,156",13039,"May 8, 1998",Paramount Pictures
336,Once Upon a Time... in Hollywood,41082018,142502728,101420710,28.80,"3,659",11227,"Jul 26, 2019",Sony Pictures Releasing
337,Shutter Island,41062440,128012934,86950494,32.10,"2,991",13728,"Feb 19, 2010",Paramount Pictures
338,Twister,41059405,241721524,200662119,17,"2,414",17008,"May 10, 1996",Warner Bros.
339,Independence Day: Resurgence,41039944,103144286,62104342,39.80,"4,130",9937,"Jun 24, 2016",Twentieth Century Fox
340,Madea Goes to Jail,41030947,90508336,49477389,45.30,"2,032",20192,"Feb 20, 2009",Lionsgate
341,Casino Royale,40833156,167445960,126612804,24.40,"3,434",11890,"Nov 17, 2006",Sony Pictures Releasing
342,Paranormal Activity 2,40678424,84752907,44074483,48,"3,216",12648,"Oct 22, 2010",Paramount Pictures
343,Friday the 13th,40570365,65002019,24431654,62.40,"3,105",13066,"Feb 13, 2009",Warner Bros.
344,Grown Ups,40506562,162001186,121494624,25,"3,534",11461,"Jun 25, 2010",Sony Pictures Releasing
345,G.I. Joe: Retaliation,40501814,122523060,82021246,33.10,"3,719",10890,"Mar 28, 2013",Paramount Pictures
346,Batman,40489746,251188924,210699178,16.10,"2,194",18454,"Jun 23, 1989",Warner Bros.
347,The Mummy: Tomb of the Dragon Emperor,40457770,102491776,62034006,39.50,"3,760",10760,"Aug 1, 2008",Universal Pictures
348,The Conjuring 2,40406314,102470008,62063694,39.40,"3,343",12086,"Jun 10, 2016",Warner Bros.
349,Glass,40328920,111048468,70719548,36.30,"3,841",10499,"Jan 18, 2019",Universal Pictures
350,The Last Airbender,40325019,131772187,91447168,30.60,"3,169",12724,"Jul 1, 2010",Paramount Pictures
351,Daredevil,40310419,102543518,62233099,39.30,"3,471",11613,"Feb 14, 2003",Twentieth Century Fox
352,Power Rangers,40300288,85364450,45064162,47.20,"3,693",10912,"Mar 24, 2017",Lionsgate
353,Insidious: Chapter 2,40272103,83586447,43314344,48.20,"3,049",13208,"Sep 13, 2013",FilmDistrict
354,Scary Movie 4,40222875,90710620,50487745,44.30,"3,602",11166,"Apr 14, 2006",-
355,Safe House,40172720,126373434,86200714,31.80,"3,119",12880,"Feb 10, 2012",Universal Pictures
356,Charlie's Angels,40128550,125305545,85176995,32,"3,037",13213,"Nov 3, 2000",Sony Pictures Releasing
357,The Fast and the Furious,40089015,144533925,104444910,27.70,"2,628",15254,"Jun 22, 2001",Universal Pictures
358,Cloverfield,40058229,80048433,39990204,50,"3,411",11743,"Jan 18, 2008",Paramount Pictures
359,Chicken Little,40049778,135386665,95336887,29.60,"3,654",10960,"Nov 4, 2005",Walt Disney Studios Motion Pictures
360,Click,40011365,137355633,97344268,29.10,"3,749",10672,"Jun 23, 2006",Revolution Studios
361,Split,40010975,138291365,98280390,28.90,"3,038",13170,"Jan 20, 2017",Universal Pictures
362,50 First Dates,39852237,120908074,81055837,33,"3,591",11097,"Feb 13, 2004",Sony Pictures Releasing
363,Wild Hogs,39699023,168273550,128574527,23.60,"3,287",12077,"Mar 2, 2007",Walt Disney Studios Motion Pictures
364,Sherlock Holmes: A Game of Shadows,39637079,186848418,147211339,21.20,"3,703",10704,"Dec 16, 2011",Warner Bros.
365,The Waterboy,39414071,161491646,122077575,24.40,"2,664",14795,"Nov 6, 1998",Walt Disney Studios Motion Pictures
366,Rio 2,39327869,131538435,92210566,29.90,"3,948",9961,"Apr 11, 2014",Twentieth Century Fox
367,Rio,39225962,143619809,104393847,27.30,"3,826",10252,"Apr 15, 2011",Twentieth Century Fox
368,Taken 3,39201657,89256424,50054767,43.90,"3,594",10907,"Jan 9, 2015",Twentieth Century Fox
369,The Break-Up,39172785,118703275,79530490,33,"3,070",12759,"Jun 2, 2006",Universal Pictures
370,The Good Dinosaur,39155217,123087120,83931903,31.80,"3,749",10444,"Nov 25, 2015",Walt Disney Studios Motion Pictures
371,Ocean's Twelve,39153380,125544280,86390900,31.20,"3,290",11900,"Dec 10, 2004",Warner Bros.
372,The Grudge,39128715,110359362,71230647,35.50,"3,245",12058,"Oct 22, 2004",Sony Pictures Releasing
373,Magic Mike,39127170,113721571,74594401,34.40,"2,930",13353,"Jun 29, 2012",Warner Bros.
374,Onward,39119861,41629376,2509515,94,"4,310",9076,"Mar 6, 2020",Walt Disney Studios Motion Pictures
375,The Heat,39115043,159582188,120467145,24.50,"3,181",12296,"Jun 28, 2013",Twentieth Century Fox
376,Kingsman: The Golden Circle,39023010,100229647,61206637,38.90,"4,003",9748,"Sep 22, 2017",Twentieth Century Fox
377,Dinosaur,38854851,137748063,98893212,28.20,"3,257",11929,"May 19, 2000",Walt Disney Studios Motion Pictures
378,Daddy's Home,38740203,150357137,111616934,25.80,"3,271",11843,"Dec 25, 2015",Paramount Pictures
379,Get Smart,38683480,130319208,91635728,29.70,"3,911",9890,"Jun 20, 2008",Warner Bros.
380,Fifty Shades Freed,38560195,100407760,61847565,38.40,"3,768",10233,"Feb 9, 2018",Universal Pictures
381,You Don't Mess with the Zohan,38531374,100018837,61487463,38.50,"3,462",11129,"Jun 6, 2008",Sony Pictures Releasing
382,The Legend of Tarzan,38527856,126643061,88115205,30.40,"3,561",10819,"Jul 1, 2016",Warner Bros.
383,Over the Hedge,38457003,155019340,116562337,24.80,"4,059",9474,"May 19, 2006",DreamWorks
384,The Cat in the Hat,38329160,101149285,62820125,37.90,"3,464",11065,"Nov 21, 2003",Universal Pictures
385,Alien vs. Predator,38291056,80282231,41991175,47.70,"3,395",11278,"Aug 13, 2004",Twentieth Century Fox
386,The Angry Birds Movie,38155177,107509366,69354189,35.50,"3,932",9703,"May 20, 2016",Sony Pictures Releasing
387,The Bourne Legacy,38142825,113203870,75061045,33.70,"3,745",10185,"Aug 10, 2012",Universal Pictures
388,Ocean's Eleven,38107822,183417150,145309328,20.80,"3,075",12392,"Dec 7, 2001",Warner Bros.
389,Rango,38079323,123477607,85398284,30.80,"3,917",9721,"Mar 4, 2011",Paramount Pictures
390,Inglourious Basterds,38054676,120540719,82486043,31.60,"3,165",12023,"Aug 21, 2009",The Weinstein Company
391,Bee Movie,38021044,126631277,88610233,30,"3,928",9679,"Nov 2, 2007",DreamWorks
392,Ace Ventura: When Nature Calls,37804076,108385533,70581457,34.90,"2,652",14254,"Nov 10, 1995",Warner Bros.
393,Charlie's Angels: Full Throttle,37634221,100830111,63195890,37.30,"3,459",10880,"Jun 27, 2003",Sony Pictures Releasing
394,Hop,37543710,108085305,70541595,34.70,"3,579",10490,"Apr 1, 2011",Universal Pictures
395,Gone Girl,37513109,167767189,130254080,22.40,"3,014",12446,"Oct 3, 2014",Twentieth Century Fox
396,District 9,37354308,115646235,78291927,32.30,"3,049",12251,"Aug 14, 2009",TriStar Pictures
397,Pacific Rim,37285325,101802906,64517581,36.60,"3,275",11384,"Jul 12, 2013",Warner Bros.
398,Mr. Deeds,37162787,126293452,89130665,29.40,"3,231",11501,"Jun 28, 2002",Sony Pictures Releasing
399,Annabelle,37134255,84273813,47139558,44.10,"3,185",11659,"Oct 3, 2014",Warner Bros.
400,Air Force One,37132505,172956409,135823904,21.50,"2,919",12720,"Jul 25, 1997",Sony Pictures Releasing
401,S.W.A.T.,37062535,116934650,79872115,31.70,"3,202",11574,"Aug 8, 2003",Sony Pictures Releasing
402,Oblivion,37054485,89107235,52052750,41.60,"3,783",9795,"Apr 19, 2013",Universal Pictures
403,Maleficent: Mistress of Evil,36948713,113929605,76980892,32.40,"3,790",9749,"Oct 18, 2019",Walt Disney Studios Motion Pictures
404,Red Dragon,36540945,93149898,56608953,39.20,"3,357",10885,"Oct 4, 2002",Universal Pictures
405,Cowboys & Aliens,36431290,100240551,63809261,36.30,"3,750",9715,"Jul 29, 2011",Universal Pictures
406,Freddy vs. Jason,36400000,82622655,46222655,44.10,"3,014",12076,"Aug 15, 2003",New Line Cinema
407,Interview with the Vampire: The Vampire Chronicles,36389705,105264608,68874903,34.60,"2,604",13974,"Nov 11, 1994",Warner Bros.
408,Marley & Me,36357586,143153751,106796165,25.40,"3,480",10447,"Dec 25, 2008",Twentieth Century Fox
409,21 Jump Street,36302612,138447667,102145055,26.20,"3,121",11631,"Mar 16, 2012",Sony Pictures Releasing
410,Kingsman: The Secret Service,36206331,128261724,92055393,28.20,"3,204",11300,"Feb 13, 2015",Twentieth Century Fox
411,Jumanji: Welcome to the Jungle,36169328,404515480,368346152,8.90,"3,765",9606,"Dec 20, 2017",Sony Pictures Releasing
412,Alien: Covenant,36160621,74262031,38101410,48.70,"3,761",9614,"May 19, 2017",Twentieth Century Fox
413,Ocean's Thirteen,36133403,117154724,81021321,30.80,"3,565",10135,"Jun 8, 2007",Warner Bros.
414,Dumb and Dumber To,36111775,86208010,50096235,41.90,"3,154",11449,"Nov 14, 2014",Universal Pictures
415,Armageddon,36089972,201578182,165488210,17.90,"3,127",11541,"Jul 1, 1998",Walt Disney Studios Motion Pictures
416,The Scorpion King,36075875,91047077,54971202,39.60,"3,444",10474,"Apr 19, 2002",Universal Pictures
417,Robin Hood,36063385,105269730,69206345,34.30,"3,503",10295,"May 14, 2010",Universal Pictures
418,Robots,36045301,128200012,92154711,28.10,"3,776",9545,"Mar 11, 2005",Twentieth Century Fox
419,The Equalizer 2,36011640,102084362,66072722,35.30,"3,388",10629,"Jul 20, 2018",Sony Pictures Releasing
420,Salt,36011243,118311368,82300125,30.40,"3,612",9969,"Jul 23, 2010",Sony Pictures Releasing
421,Star Wars: Episode IV - A New Hope1997 Special Edition,35906661,138257865,102351204,26,"2,104",17065,"Jan 31, 1997",Twentieth Century Fox
422,"10,000 BC",35867488,94784201,58916713,37.80,"3,410",10518,"Mar 7, 2008",Warner Bros.
423,Rampage,35753093,101028233,65275140,35.40,"4,101",8718,"Apr 13, 2018",Warner Bros.
424,Minority Report,35677125,132072926,96395801,27,"3,001",11888,"Jun 21, 2002",Twentieth Century Fox
425,Sweet Home Alabama,35648740,127223418,91574678,28,"3,293",10825,"Sep 27, 2002",Walt Disney Studios Motion Pictures
426,The Smurfs,35611637,142614158,107002521,25,"3,395",10489,"Jul 29, 2011",Sony Pictures Releasing
427,Creed II,35574710,115715889,80141179,30.70,"3,441",10338,"Nov 21, 2018",Metro-Goldwyn-Mayer (MGM)
428,Battle Los Angeles,35573187,83552429,47979242,42.60,"3,417",10410,"Mar 11, 2011",Sony Pictures Releasing
429,The Other Guys,35543162,119219978,83676816,29.80,"3,651",9735,"Aug 6, 2010",Sony Pictures Releasing
430,Central Intelligence,35535250,127440871,91905621,27.90,"3,508",10129,"Jun 17, 2016",Warner Bros.
431,The World Is Not Enough,35519007,126943684,91424677,28,"3,163",11229,"Nov 19, 1999",Metro-Goldwyn-Mayer (MGM)
432,Super 8,35451168,127004179,91553011,27.90,"3,379",10491,"Jun 10, 2011",Paramount Pictures
433,Spider-Man: Into the Spider-Verse,35363376,190241310,154877934,18.60,"3,813",9274,"Dec 14, 2018",Sony Pictures Releasing
434,Teenage Mutant Ninja Turtles: Out of the Shadows,35316382,82051601,46735219,43,"4,071",8675,"Jun 3, 2016",Paramount Pictures
435,Lilo & Stitch,35260212,145794338,110534126,24.20,"3,191",11049,"Jun 21, 2002",Walt Disney Studios Motion Pictures
436,Sing,35258145,270395425,235137280,13,"4,022",8766,"Dec 21, 2016",Universal Pictures
437,Ride Along 2,35243095,91221830,55978735,38.60,"3,175",11100,"Jan 15, 2016",Universal Pictures
438,National Treasure,35142554,173008894,137866340,20.30,"3,017",11648,"Nov 19, 2004",Walt Disney Studios Motion Pictures
439,The Ring Two,35065237,76231249,41166012,46,"3,332",10523,"Mar 18, 2005",DreamWorks Distribution
440,Runaway Bride,35055556,152257509,117201953,23,"3,158",11100,"Jul 30, 1999",Paramount Pictures
441,Sully,35028301,125070033,90041732,28,"3,525",9937,"Sep 9, 2016",Warner Bros.
442,Annabelle: Creation,35006404,102092201,67085797,34.30,"3,502",9996,"Aug 11, 2017",Warner Bros.
443,Mamma Mia! Here We Go Again,34952180,120634935,85682755,29,"3,317",10537,"Jul 20, 2018",Universal Pictures
444,The Expendables,34825135,103068524,68243389,33.80,"3,270",10649,"Aug 13, 2010",Lionsgate
445,Gladiator,34819017,187705427,152886410,18.60,"2,938",11851,"May 5, 2000",DreamWorks Distribution
446,Scream 3,34713342,89143175,54429833,38.90,"3,467",10012,"Feb 4, 2000",Dimension Films
447,The Magnificent Seven,34703397,93432655,58729258,37.10,"3,674",9445,"Sep 23, 2016",Sony Pictures Releasing
448,Identity Thief,34551025,134506920,99955895,25.70,"3,141",11000,"Feb 8, 2013",Universal Pictures
449,Hellboy II: The Golden Army,34539115,75986503,41447388,45.40,"3,204",10779,"Jul 11, 2008",Universal Pictures
450,Enchanted,34440317,127807262,93366945,27,"3,730",9233,"Nov 21, 2007",Walt Disney Studios Motion Pictures
451,Couples Retreat,34286740,109204945,74918205,31.40,"3,000",11428,"Oct 9, 2009",Universal Pictures
452,Sausage Party,34263534,97685686,63422152,35.10,"3,103",11042,"Aug 12, 2016",Sony Pictures Releasing
453,I Now Pronounce You Chuck & Larry,34233750,120059556,85825806,28.50,"3,495",9795,"Jul 20, 2007",Universal Pictures
454,Tarzan,34221968,171091819,136869851,20,"3,005",11388,"Jun 16, 1999",Walt Disney Studios Motion Pictures
455,Ransom,34216088,136492681,102276593,25.10,"2,676",12786,"Nov 8, 1996",Walt Disney Studios Motion Pictures
456,Norbit,34195434,95673607,61478173,35.70,"3,136",10904,"Feb 9, 2007",DreamWorks
457,The Equalizer,34137828,101530738,67392910,33.60,"3,236",10549,"Sep 26, 2014",Sony Pictures Releasing
458,The Blind Side,34119372,255959475,221840103,13.30,"3,110",10970,"Nov 20, 2009",Warner Bros.
459,The Lego Movie 2: The Second Part,34115335,105806508,71691173,32.20,"4,303",7928,"Feb 8, 2019",Warner Bros.
460,Puss in Boots,34077439,149260504,115183065,22.80,"3,952",8622,"Oct 28, 2011",DreamWorks
461,The Purge,34058360,64473115,30414755,52.80,"2,536",13429,"Jun 7, 2013",Universal Pictures
462,Lethal Weapon 4,34048124,130444603,96396479,26.10,"3,117",10923,"Jul 10, 1998",Warner Bros.
463,Cloudy with a Chance of Meatballs 2,34017930,119793567,85775637,28.40,"4,001",8502,"Sep 27, 2013",Sony Pictures Releasing
464,Get Hard,33803253,90411453,56608200,37.40,"3,175",10646,"Mar 27, 2015",Warner Bros.
465,The Devil Inside,33732515,53261944,19529429,63.30,"2,285",14762,"Jan 6, 2012",Paramount Pictures
466,Think Like a Man,33636303,91547205,57910902,36.70,"2,015",16692,"Apr 20, 2012",Screen Gems
467,The Proposal,33627598,163958031,130330433,20.50,"3,056",11003,"Jun 19, 2009",Walt Disney Studios Motion Pictures
468,What Women Want,33614543,182811707,149197164,18.40,"3,012",11160,"Dec 15, 2000",Paramount Pictures
469,Saw III,33610391,80238724,46628333,41.90,"3,167",10612,"Oct 27, 2006",Lionsgate
470,Epic,33531068,107518682,73987614,31.20,"3,882",8637,"May 24, 2013",Twentieth Century Fox
471,The Green Hornet,33526876,98780042,65253166,33.90,"3,584",9354,"Jan 14, 2011",Sony Pictures Releasing
472,Ted 2,33507870,81476385,47968515,41.10,"3,442",9735,"Jun 26, 2015",Universal Pictures
473,101 Dalmatians,33504025,136189294,102685269,24.60,"2,794",11991,"Nov 27, 1996",Walt Disney Studios Motion Pictures
474,Wrath of the Titans,33457188,83670083,50212895,40,"3,545",9437,"Mar 30, 2012",Warner Bros.
475,The Haunting,33435140,91411151,57976011,36.60,"2,808",11907,"Jul 23, 1999",DreamWorks Distribution
476,Get Out,33377060,176040665,142663605,19,"2,781",12001,"Feb 24, 2017",Universal Pictures
477,Live Free or Die Hard,33369559,134529403,101159844,24.80,"3,408",9791,"Jun 27, 2007",Twentieth Century Fox
478,American Wedding,33369440,104565114,71195674,31.90,"3,172",10520,"Aug 1, 2003",Universal Pictures
479,Lethal Weapon 3,33243086,144731527,111488441,23,"2,510",13244,"May 15, 1992",Warner Bros.
480,Hustlers,33181361,104963598,71782237,31.60,"3,250",10209,"Sep 13, 2019",STX Entertainment
481,A Wrinkle in Time,33123609,100478608,67354999,33,"3,980",8322,"Mar 9, 2018",Walt Disney Studios Motion Pictures
482,Superbad,33052411,121463226,88410815,27.20,"2,948",11211,"Aug 17, 2007",Sony Pictures Releasing
483,Tomorrowland,33028165,93436322,60408157,35.40,"3,972",8315,"May 22, 2015",Walt Disney Studios Motion Pictures
484,Blades of Glory,33014202,118594548,85580346,27.80,"3,372",9790,"Mar 30, 2007",DreamWorks
485,Birds of Prey: And the Fantabulous Emancipation of One Harley Quinn,33010017,82771910,49761893,39.90,"4,236",7792,"Feb 7, 2020",Warner Bros.
486,Rush Hour,33001803,141186864,108185061,23.40,"2,638",12510,"Sep 18, 1998",New Line Cinema
487,Scream 2,32926342,101363301,68436959,32.50,"2,663",12364,"Dec 12, 1997",Dimension Films
488,A Nightmare on Elm Street,32902299,63075011,30172712,52.20,"3,332",9874,"Apr 30, 2010",Warner Bros.
489,X-Men: Dark Phoenix,32828348,65845974,33017626,49.90,"3,721",8822,"Jun 7, 2019",Twentieth Century Fox
490,The Book of Eli,32789494,94835059,62045565,34.60,"3,111",10539,"Jan 15, 2010",Warner Bros.
491,Blade Runner 2049,32753122,92054159,59301037,35.60,"4,058",8071,"Oct 6, 2017",Warner Bros.
492,Where the Wild Things Are,32695407,77233467,44538060,42.30,"3,735",8753,"Oct 16, 2009",Warner Bros.
493,Due Date,32689406,100539043,67849637,32.50,"3,355",9743,"Nov 5, 2010",Warner Bros.
494,Blade II,32528016,82348319,49820303,39.50,"2,707",12016,"Mar 22, 2002",New Line Cinema
495,The Maze Runner,32512804,102427862,69915058,31.70,"3,604",9021,"Sep 19, 2014",Twentieth Century Fox
496,Spy Kids 3-D: Game Over,32500000,111761982,79261982,29.10,"3,344",9718,"Jul 25, 2003",Dimension Films
497,Hannah Montana: The Movie,32324487,79576189,47251702,40.60,"3,118",10367,"Apr 10, 2009",Walt Disney Studios Motion Pictures
498,Mr. Peabody & Sherman,32207057,111506430,79299373,28.90,"3,934",8186,"Mar 7, 2014",Twentieth Century Fox
499,Immortals,32206425,83504017,51297592,38.60,"3,112",10349,"Nov 11, 2011",Relativity Media
500,Wedding Crashers,32200000,209255921,177055921,15.40,"2,925",11008,"Jul 15, 2005",New Line Cinema
501,Elf,32100000,173398518,141298518,18.50,"3,337",9619,"Nov 7, 2003",New Line Cinema
502,Bad Grandpa,32055177,102003019,69947842,31.40,"3,336",9608,"Oct 25, 2013",Paramount Pictures
503,The SpongeBob SquarePants Movie,32018216,85417988,53399772,37.50,"3,212",9968,"Nov 19, 2004",Paramount Pictures
504,Paul Blart: Mall Cop,31832636,146336178,114503542,21.80,"3,144",10124,"Jan 16, 2009",Sony Pictures Releasing
505,Terminator 2: Judgment Day,31765506,204843345,173077839,15.50,"2,274",13969,"Jul 3, 1991",TriStar Pictures
506,Saw IV,31756764,63300095,31543331,50.20,"3,183",9976,"Oct 26, 2007",Lionsgate
507,Saw II,31725652,87039965,55314313,36.40,"2,949",10758,"Oct 28, 2005",Lionsgate
508,G-Force,31706934,119436770,87729836,26.60,"3,697",8576,"Jul 24, 2009",Walt Disney Studios Motion Pictures
509,The Mummy,31688375,80227895,48539520,39.50,"4,035",7853,"Jun 9, 2017",Universal Pictures
510,Bad Teacher,31603106,100292856,68689750,31.50,"3,049",10365,"Jun 24, 2011",Sony Pictures Releasing
511,The Truman Show,31542121,125618201,94076080,25.10,"2,315",13625,"Jun 5, 1998",Paramount Pictures
512,The Purge: Election Year,31515110,79213375,47698265,39.80,"2,796",11271,"Jul 1, 2016",Universal Pictures
513,The Wolfman,31479235,61979680,30500445,50.80,"3,222",9770,"Feb 12, 2010",Universal Pictures
514,Ford v Ferrari,31474958,117594481,86119523,26.80,"3,528",8921,"Nov 15, 2019",Twentieth Century Fox
515,Liar Liar,31423025,181410615,149987590,17.30,"2,845",11045,"Mar 21, 1997",Universal Pictures
516,Percy Jackson & the Olympians: The Lightning Thief,31236067,88768303,57532236,35.20,"3,356",9307,"Feb 12, 2010",Twentieth Century Fox
517,Girls Trip,31201920,115171585,83969665,27.10,"2,591",12042,"Jul 21, 2017",Universal Pictures
518,Evan Almighty,31192615,100462298,69269683,31,"3,604",8654,"Jun 22, 2007",Universal Pictures
519,The Sum of All Fears,31178526,118907036,87728510,26.20,"3,183",9795,"May 31, 2002",Paramount Pictures
520,Home Alone 2: Lost in New York,31126882,173585516,142458634,17.90,"2,222",14008,"Nov 20, 1992",Twentieth Century Fox
521,Hannah Montana and Miley Cyrus: Best of Both Worlds Concert,31117834,65281781,34163947,47.70,683,45560,"Feb 1, 2008",Walt Disney Studios Motion Pictures
522,Bringing Down the House,31101026,132716677,101615651,23.40,"2,801",11103,"Mar 7, 2003",Walt Disney Studios Motion Pictures
523,Four Christmases,31069826,120146040,89076214,25.90,"3,310",9386,"Nov 26, 2008",Warner Bros.
524,Into the Woods,31051923,128002372,96950449,24.30,"2,440",12726,"Dec 25, 2014",Walt Disney Studios Motion Pictures
525,Pokémon: The First Movie - Mewtwo Strikes Back,31036678,85744662,54707984,36.20,"3,043",10199,"Nov 10, 1999",Warner Bros.
526,Downton Abbey,31033665,96854135,65820470,32,"3,079",10079,"Sep 20, 2019",Focus Features
527,Sex and the City 2,31001870,95347692,64345822,32.50,"3,445",8999,"May 27, 2010",Warner Bros.
528,Step Brothers,30940732,100468793,69528061,30.80,"3,094",10000,"Jul 25, 2008",Sony Pictures Releasing
529,Little Fockers,30833665,148438600,117604935,20.80,"3,536",8719,"Dec 22, 2010",Universal Pictures
530,Star Trek: First Contact,30716131,92027888,61311757,33.40,"2,812",10923,"Nov 22, 1996",Paramount Pictures
531,Knocked Up,30690990,148768917,118077927,20.60,"2,871",10690,"Jun 1, 2007",Universal Pictures
532,The Dukes of Hazzard,30675314,80270227,49594913,38.20,"3,785",8104,"Aug 5, 2005",Warner Bros.
533,Unbroken,30621445,115637895,85016450,26.50,"3,131",9780,"Dec 25, 2014",Universal Pictures
534,Brüno,30619130,60054530,29435400,51,"2,756",11109,"Jul 10, 2009",Universal Pictures
535,Saving Private Ryan,30576104,216540909,185964805,14.10,"2,463",12414,"Jul 24, 1998",DreamWorks Distribution
536,The Pacifier,30552694,113086868,82534174,27,"3,131",9758,"Mar 4, 2005",Walt Disney Studios Motion Pictures
537,Bram Stoker's Dracula,30521679,82522790,52001111,37,"2,491",12252,"Nov 13, 1992",Columbia Pictures
538,The Happening,30517109,64506874,33989765,47.30,"2,986",10220,"Jun 13, 2008",Twentieth Century Fox
539,Just Go with It,30514732,103028109,72513377,29.60,"3,548",8600,"Feb 11, 2011",Sony Pictures Releasing
540,The Day the Earth Stood Still,30480153,79366978,48886825,38.40,"3,560",8561,"Dec 12, 2008",Twentieth Century Fox
541,Dear John,30468614,80014842,49546228,38.10,"2,969",10262,"Feb 5, 2010",Screen Gems
542,John Wick: Chapter 2,30436123,92029184,61593061,33.10,"3,113",9777,"Feb 10, 2017",Lionsgate
543,Night at the Museum,30433781,250863268,220429487,12.10,"3,685",8258,"Dec 22, 2006",Twentieth Century Fox
544,Olympus Has Fallen,30373794,98925640,68551846,30.70,"3,098",9804,"Mar 22, 2013",FilmDistrict
545,Unbreakable,30330771,95011339,64680568,31.90,"2,708",11200,"Nov 22, 2000",Walt Disney Studios Motion Pictures
546,Maze Runner: The Scorch Trials,30316510,81697192,51380682,37.10,"3,791",7996,"Sep 18, 2015",Twentieth Century Fox
547,Cloudy with a Chance of Meatballs,30304648,124870275,94565627,24.30,"3,119",9716,"Sep 18, 2009",Sony Pictures Releasing
548,The Addams Family,30300007,100044905,69744898,30.30,"4,007",7561,"Oct 11, 2019",United Artists Releasing
549,America's Sweethearts,30181877,93607673,63425796,32.20,"3,011",10023,"Jul 20, 2001",Revolution Studios
550,John Carter,30180188,73078100,42897912,41.30,"3,749",8050,"Mar 9, 2012",Walt Disney Studios Motion Pictures
551,The Lion King2011 3D Release,30151614,94242001,64090387,32,"2,330",12940,"Sep 16, 2011",Walt Disney Studios Motion Pictures
552,The X Files,30138758,83898313,53759555,35.90,"2,629",11463,"Jun 19, 1998",Twentieth Century Fox
553,Django Unchained,30122888,162805434,132682546,18.50,"3,010",10007,"Dec 25, 2012",The Weinstein Company
554,The Best Man Holiday,30107555,70525195,40417640,42.70,"2,024",14875,"Nov 15, 2013",Universal Pictures
555,Trainwreck,30097040,110212700,80115660,27.30,"3,158",9530,"Jul 17, 2015",Universal Pictures
556,Prince of Persia: The Sands of Time,30095259,90759676,60664417,33.20,"3,646",8254,"May 28, 2010",Walt Disney Studios Motion Pictures
557,Dodgeball: A True Underdog Story,30070196,114326736,84256540,26.30,"2,694",11161,"Jun 18, 2004",Twentieth Century Fox
558,Lemony Snicket's A Series of Unfortunate Events,30061756,118634549,88572793,25.30,"3,620",8304,"Dec 17, 2004",Paramount Pictures
559,Sleepy Hollow,30060467,101071502,71011035,29.70,"3,064",9810,"Nov 19, 1999",Paramount Pictures
560,Panic Room,30056751,96397334,66340583,31.20,"3,053",9844,"Mar 29, 2002",Sony Pictures Releasing
561,The Exorcism of Emily Rose,30054300,75072454,45018154,40,"2,981",10081,"Sep 9, 2005",Screen Gems
562,Saw V,30053954,56746769,26692815,53,"3,060",9821,"Oct 24, 2008",Lionsgate
563,Catch Me If You Can,30053627,164615351,134561724,18.30,"3,156",9522,"Dec 25, 2002",DreamWorks Distribution
564,A Christmas Carol,30051075,137855863,107804788,21.80,"3,683",8159,"Nov 6, 2009",Walt Disney Studios Motion Pictures
565,Men in Black: International,30035838,80001807,49965969,37.50,"4,224",7110,"Jun 14, 2019",Sony Pictures Releasing
566,Madea's Family Reunion,30030661,63257940,33227279,47.50,"2,194",13687,"Feb 24, 2006",Lionsgate
567,The Purge: Anarchy,29816675,71962800,42146125,41.40,"2,805",10629,"Jul 18, 2014",Universal Pictures
568,Elysium,29807393,93050117,63242724,32,"3,284",9076,"Aug 9, 2013",TriStar Pictures
569,Hercules,29800263,72688614,42888351,41,"3,595",8289,"Jul 25, 2014",Paramount Pictures
570,Constantine,29769098,75976178,46207080,39.20,"3,006",9903,"Feb 18, 2005",Warner Bros.
571,What Lies Beneath,29702959,155464351,125761392,19.10,"2,813",10559,"Jul 21, 2000",DreamWorks Distribution
572,The Flintstones,29688730,130531208,100842478,22.70,"2,498",11885,"May 27, 1994",Universal Pictures
573,Dark Shadows,29685274,79727149,50041875,37.20,"3,755",7905,"May 11, 2012",Warner Bros.
574,Daddy's Home 2,29651193,104029443,74378250,28.50,"3,575",8294,"Nov 10, 2017",Paramount Pictures
575,Creed,29632823,109767581,80134758,27,"3,404",8705,"Nov 25, 2015",Warner Bros.
576,Insidious: The Last Key,29581355,67745330,38163975,43.70,"3,116",9493,"Jan 5, 2018",Universal Pictures
577,Justin Bieber: Never Say Never,29514054,73013910,43499856,40.40,"3,105",9505,"Feb 11, 2011",Paramount Pictures
578,Ghostbusters II,29472894,112494738,83021844,26.20,"2,410",12229,"Jun 16, 1989",Columbia Pictures
579,Scooby-Doo 2: Monsters Unleashed,29438331,84216833,54778502,35,"3,312",8888,"Mar 26, 2004",Warner Bros.
580,Indiana Jones and the Last Crusade,29355021,197171806,167816785,14.90,"2,327",12614,"May 24, 1989",Paramount Pictures
581,A.I. Artificial Intelligence,29352630,78616689,49264059,37.30,"3,242",9053,"Jun 29, 2001",Warner Bros.
582,Now You See Me,29350389,117723989,88373600,24.90,"2,925",10034,"May 31, 2013",Lionsgate
583,Beverly Hills Chihuahua,29300465,94514402,65213937,31,"3,215",9113,"Oct 3, 2008",Walt Disney Studios Motion Pictures
584,Why Did I Get Married Too?,29289537,60095852,30806315,48.70,"2,155",13591,"Apr 2, 2010",Lionsgate
585,Think Like a Man Too,29241911,65182182,35940271,44.90,"2,225",13142,"Jun 20, 2014",Screen Gems
586,The Muppets,29239026,88631237,59392211,33,"3,440",8499,"Nov 23, 2011",Walt Disney Studios Motion Pictures
587,The Lone Ranger,29210849,89302115,60091266,32.70,"3,904",7482,"Jul 3, 2013",Walt Disney Studios Motion Pictures
588,Eagle Eye,29150721,101440743,72290022,28.70,"3,510",8305,"Sep 26, 2008",DreamWorks
589,Toy Story,29140617,191796233,162655616,15.20,"2,457",11860,"Nov 22, 1995",Walt Disney Studios Motion Pictures
590,The Texas Chainsaw Massacre,29100000,80571655,51471655,36.10,"3,016",9648,"Oct 17, 2003",New Line Cinema
591,Spy,29085719,110825712,81739993,26.20,"3,711",7837,"Jun 5, 2015",Twentieth Century Fox
592,Terminator: Dark Fate,29033832,62253077,33219245,46.60,"4,086",7105,"Nov 1, 2019",Paramount Pictures
593,Allegiant,29027348,66184051,37156703,43.90,"3,740",7761,"Mar 18, 2016",Lionsgate
594,Doctor Dolittle,29014324,144156605,115142281,20.10,"2,777",10448,"Jun 26, 1998",Twentieth Century Fox
595,The Santa Clause 2,29008696,139236327,110227631,20.80,"3,350",8659,"Nov 1, 2002",Walt Disney Studios Motion Pictures
596,Paranormal Activity 4,29003866,53885000,24881134,53.80,"3,412",8500,"Oct 19, 2012",Paramount Pictures
597,Jackass Number Two,29002002,72778712,43776710,39.80,"3,059",9480,"Sep 22, 2006",Paramount Pictures
598,Inside Man,28954945,88513495,59558550,32.70,"2,818",10274,"Mar 24, 2006",Universal Pictures
599,Cast Away,28883406,233632142,204748736,12.40,"2,774",10412,"Dec 22, 2000",Twentieth Century Fox
600,Non-Stop,28875635,92168600,63292965,31.30,"3,090",9344,"Feb 28, 2014",Universal Pictures
601,Miss Peregrine's Home for Peculiar Children,28871140,87242834,58371694,33.10,"3,522",8197,"Sep 30, 2016",Twentieth Century Fox
602,Edge of Tomorrow,28760246,100206256,71446010,28.70,"3,490",8240,"Jun 6, 2014",Warner Bros.
603,Murder on the Orient Express,28681472,102826543,74145071,27.90,"3,341",8584,"Nov 10, 2017",Twentieth Century Fox
604,Titanic,28638131,600788188,572150057,4.80,"2,674",10709,"Dec 19, 1997",Paramount Pictures
605,Meet the Parents,28623300,166244045,137620745,17.20,"2,614",10950,"Oct 6, 2000",Universal Pictures
606,Obsessed,28612730,68261644,39648914,41.90,"2,514",11381,"Apr 24, 2009",Screen Gems
607,The Expendables 2,28591370,85028192,56436822,33.60,"3,316",8622,"Aug 17, 2012",Lionsgate
608,Alita: Battle Angel,28525613,85710210,57184597,33.30,"3,790",7526,"Feb 14, 2019",Twentieth Century Fox
609,Tyler Perry's Boo! A Madea Halloween,28501448,73206343,44704895,38.90,"2,260",12611,"Oct 21, 2016",Lionsgate
610,Anchorman: The Legend of Ron Burgundy,28416365,85288303,56871938,33.30,"3,091",9193,"Jul 9, 2004",DreamWorks Distribution
611,Mama,28402310,71628180,43225870,39.60,"2,647",10730,"Jan 18, 2013",Universal Pictures
612,Nacho Libre,28309599,80197993,51888394,35.30,"3,070",9221,"Jun 16, 2006",Paramount Pictures
613,Horrible Bosses,28302165,117538559,89236394,24.10,"3,040",9309,"Jul 8, 2011",Warner Bros.
614,The Invisible Man,28205665,54026015,25820350,52.20,"3,610",7813,"Feb 28, 2020",Universal Pictures
615,Erin Brockovich,28138465,125595205,97456740,22.40,"2,848",9880,"Mar 17, 2000",Universal Pictures
616,Pacific Rim: Uprising,28116535,59874525,31757990,47,"3,708",7582,"Mar 23, 2018",Universal Pictures
617,Starsky & Hutch,28103367,88237754,60134387,31.80,"3,185",8823,"Mar 5, 2004",Warner Bros.
618,Sin City,28100000,74103820,46003820,37.90,"3,230",8699,"Apr 1, 2005",Dimension Films
619,Back to the Future Part II,27835125,118450002,90614877,23.50,"1,865",14925,"Nov 22, 1989",Universal Pictures
620,Hairspray,27800000,118871849,91071849,23.40,"3,121",8907,"Jul 20, 2007",New Line Cinema
621,The Matrix,27788331,171479930,143691599,16.20,"2,849",9753,"Mar 31, 1999",Warner Bros.
622,He's Just Not That Into You,27785487,93953653,66168166,29.60,"3,175",8751,"Feb 6, 2009",Warner Bros.
623,Mamma Mia!,27751240,144130063,116378823,19.20,"2,976",9325,"Jul 18, 2008",Universal Pictures
624,Big Momma's House 2,27736056,70165972,42429916,39.50,"3,261",8505,"Jan 27, 2006",Twentieth Century Fox
625,Jarhead,27726210,62658220,34932010,44.20,"2,411",11499,"Nov 4, 2005",Universal Pictures
626,Along Came Polly,27721185,88097164,60375979,31.50,"2,984",9289,"Jan 16, 2004",Universal Pictures
627,Wild Wild West,27687484,113804681,86117197,24.30,"3,342",8284,"Jun 30, 1999",Warner Bros.
628,Daddy Day Care,27623580,104297061,76673481,26.50,"3,370",8196,"May 9, 2003",Revolution Studios
629,The Ugly Truth,27605576,88915214,61309638,31,"2,882",9578,"Jul 24, 2009",Sony Pictures Releasing
630,Cheaper by the Dozen,27557647,138614544,111056897,19.90,"3,298",8355,"Dec 25, 2003",Twentieth Century Fox
631,Wonder,27547866,132422809,104874943,20.80,"3,096",8897,"Nov 17, 2017",Lionsgate
632,The Devil Wears Prada,27537244,124740460,97203216,22.10,"2,847",9672,"Jun 30, 2006",Twentieth Century Fox
633,Space Jam,27528529,90418342,62889813,30.40,"2,650",10388,"Nov 15, 1996",Warner Bros.
634,After Earth,27520040,60522097,33002057,45.50,"3,401",8091,"May 31, 2013",Sony Pictures Releasing
635,Beowulf,27515871,82280579,54764708,33.40,"3,153",8726,"Nov 16, 2007",Paramount Pictures
636,42,27487144,95020213,67533069,28.90,"3,003",9153,"Apr 12, 2013",Warner Bros.
637,Bedtime Stories,27450296,110101975,82651679,24.90,"3,681",7457,"Dec 25, 2008",Walt Disney Studios Motion Pictures
638,The Final Destination,27408309,66477700,39069391,41.20,"3,121",8781,"Aug 28, 2009",Warner Bros.
639,Jumper,27354808,80172128,52817320,34.10,"3,428",7979,"Feb 14, 2008",Twentieth Century Fox
640,Journey 2: The Mysterious Island,27335363,103860290,76524927,26.30,"3,470",7877,"Feb 10, 2012",Warner Bros.
641,The Rugrats Movie,27321470,100494675,73173205,27.20,"2,782",9820,"Nov 20, 1998",Paramount Pictures
642,Real Steel,27319677,85468508,58148831,32,"3,440",7941,"Oct 7, 2011",Walt Disney Studios Motion Pictures
643,Les Misérables,27281735,148809770,121528035,18.30,"2,814",9695,"Dec 25, 2012",Universal Pictures
644,Night School,27257615,77339130,50081515,35.20,"3,010",9055,"Sep 28, 2018",Universal Pictures
645,Jack the Giant Slayer,27202226,65187603,37985377,41.70,"3,525",7716,"Mar 1, 2013",Warner Bros.
646,The Bourne Identity,27118640,121661683,94543043,22.30,"2,638",10280,"Jun 14, 2002",Universal Pictures
647,A Madea Family Funeral,27062332,73257045,46194713,36.90,"2,442",11082,"Mar 1, 2019",Lionsgate
648,2 Guns,27059130,75612460,48553330,35.80,"3,025",8945,"Aug 2, 2013",Universal Pictures
649,Terminator Genisys,27018486,89760956,62742470,30.10,"3,758",7189,"Jul 1, 2015",Paramount Pictures
650,Ender's Game,27017351,61737191,34719840,43.80,"3,407",7929,"Nov 1, 2013",Lionsgate
651,The Departed,26887467,132384315,105496848,20.30,"3,017",8911,"Oct 6, 2006",Warner Bros.
652,Alice Through the Looking Glass,26858726,77041381,50182655,34.90,"3,763",7137,"May 27, 2016",Walt Disney Studios Motion Pictures
653,Underworld: Evolution,26857181,62318875,35461694,43.10,"3,207",8374,"Jan 20, 2006",Screen Gems
654,The Curious Case of Benjamin Button,26853816,127509326,100655510,21.10,"2,988",8987,"Dec 25, 2008",Paramount Pictures
655,Zombieland: Double Tap,26803104,73123082,46319978,36.60,"3,468",7728,"Oct 18, 2019",Sony Pictures Releasing
656,Knives Out,26769548,165179842,138410294,16.20,"3,461",7734,"Nov 27, 2019",Lionsgate
657,Flubber,26725207,92977226,66252019,28.70,"2,641",10119,"Nov 26, 1997",Walt Disney Studios Motion Pictures
658,Dawn of the Dead,26722575,59020957,32298382,45.30,"2,745",9735,"Mar 19, 2004",Universal Pictures
659,The Sixth Sense,26681262,293506292,266825030,9.10,"2,161",12346,"Aug 6, 1999",Walt Disney Studios Motion Pictures
660,Resident Evil: Afterlife,26650264,60128566,33478302,44.30,"3,203",8320,"Sep 10, 2010",Screen Gems
661,The House with a Clock in Its Walls,26608020,68549695,41941675,38.80,"3,592",7407,"Sep 21, 2018",Universal Pictures
662,The Campaign,26588460,86907746,60319286,30.60,"3,205",8295,"Aug 10, 2012",Warner Bros.
663,Spy Kids,26546881,112719001,86172120,23.60,"3,104",8552,"Mar 30, 2001",Miramax
664,The Pursuit of Happyness,26541709,163566459,137024750,16.20,"2,852",9306,"Dec 15, 2006",Sony Pictures Releasing
665,Crazy Rich Asians,26510140,174532921,148022781,15.20,"3,384",7833,"Aug 15, 2018",Warner Bros.
666,Borat: Cultural Learnings of America for Make Benefit Glorious Nation of Kazakhstan,26455463,128505958,102050495,20.60,837,31607,"Nov 3, 2006",Twentieth Century Fox
667,All Eyez on Me,26435354,44922302,18486948,58.80,"2,471",10698,"Jun 16, 2017",Lionsgate
668,We're the Millers,26419396,150394119,123974723,17.60,"3,260",8104,"Aug 7, 2013",Warner Bros.
669,Hollow Man,26414386,73209340,46794954,36.10,"2,956",8935,"Aug 4, 2000",Sony Pictures Releasing
670,Don't Breathe,26411706,89217875,62806169,29.60,"3,051",8656,"Aug 26, 2016",Screen Gems
671,Halloween,26362367,58272029,31909662,45.20,"3,472",7592,"Aug 31, 2007",-
672,Beverly Hills Cop II,26348555,153665036,127316481,17.20,"2,326",11327,"May 20, 1987",Paramount Pictures
673,The Curse of la Llorona,26347631,54733739,28386108,48.10,"3,372",7813,"Apr 19, 2019",Warner Bros.
674,Bridesmaids,26247410,169106725,142859315,15.50,"2,918",8995,"May 13, 2011",Universal Pictures
675,Anchorman 2: The Legend Continues,26232425,125168368,98935943,21,"3,507",7480,"Dec 18, 2013",Paramount Pictures
676,Bolt,26223128,114053579,87830451,23,"3,651",7182,"Nov 21, 2008",Walt Disney Studios Motion Pictures
677,GoldenEye,26205007,106429941,80224934,24.60,"2,667",9825,"Nov 17, 1995",Metro-Goldwyn-Mayer (MGM)
678,The Golden Compass,26125000,70107728,43982728,37.30,"3,528",7405,"Dec 7, 2007",New Line Cinema
679,The Help,26044590,169708112,143663522,15.40,"2,534",10278,"Aug 10, 2011",Walt Disney Studios Motion Pictures
680,Happy Death Day,26039025,55683845,29644820,46.80,"3,149",8268,"Oct 13, 2017",Universal Pictures
681,The Perfect Guy,25888154,57027435,31139281,45.40,"2,221",11656,"Sep 11, 2015",Screen Gems
682,True Lies,25869770,146282411,120412641,17.70,"2,368",10924,"Jul 15, 1994",Twentieth Century Fox
683,Tropic Thunder,25812796,110515313,84702517,23.40,"3,319",7777,"Aug 13, 2008",DreamWorks
684,Evil Dead,25775847,54239856,28464009,47.50,"3,025",8520,"Apr 5, 2013",TriStar Pictures
685,Rocketman,25725722,96368160,70642438,26.70,"3,610",7126,"May 31, 2019",Paramount Pictures
686,Miami Vice,25723815,63450470,37726655,40.50,"3,021",8515,"Jul 28, 2006",Universal Pictures
687,Captain Phillips,25718314,107100855,81382541,24,"3,020",8515,"Oct 11, 2013",Sony Pictures Releasing
688,Fantastic Four,25685737,56117548,30431811,45.80,"3,995",6429,"Aug 7, 2015",Twentieth Century Fox
689,The A-Team,25669455,77222099,51552644,33.20,"3,535",7261,"Jun 11, 2010",Twentieth Century Fox
690,Big Momma's House,25661041,117559438,91898397,21.80,"2,802",9158,"Jun 2, 2000",Twentieth Century Fox
691,About Last Night,25649011,48637684,22988673,52.70,"2,253",11384,"Feb 14, 2014",Screen Gems
692,V for Vendetta,25642340,70511035,44868695,36.40,"3,365",7620,"Mar 17, 2006",Warner Bros.
693,Robin Hood: Prince of Thieves,25625602,165493908,139868306,15.50,"2,369",10817,"Jun 14, 1991",Warner Bros.
694,Son of God,25601865,59700064,34098199,42.90,"3,260",7853,"Feb 28, 2014",Twentieth Century Fox
695,Kill Bill: Vol. 2,25600000,66208183,40608183,38.70,"2,971",8616,"Apr 16, 2004",Miramax
696,Total Recall,25577758,58877969,33300211,43.40,"3,601",7102,"Aug 3, 2012",Sony Pictures Releasing
697,Battleship,25534825,65422625,39887800,39,"3,690",6920,"May 18, 2012",Universal Pictures
698,Total Recall,25533700,119394840,93861140,21.40,"2,060",12395,"Jun 1, 1990",Sony Pictures Releasing
699,Penguins of Madagascar,25447444,83850911,58403467,30.40,"3,764",6760,"Nov 26, 2014",Twentieth Century Fox
700,The Visit,25427560,65206105,39778545,39,"3,069",8285,"Sep 11, 2015",Universal Pictures
701,The Nutty Professor,25411725,128814019,103402294,19.70,"2,115",12015,"Jun 28, 1996",Universal Pictures
702,The Firm,25400000,158348367,132948367,16,"2,393",10614,"Jul 2, 1993",Paramount Pictures
703,Teenage Mutant Ninja Turtles,25398367,135265915,109867548,18.80,"2,006",12661,"Mar 30, 1990",New Line Cinema
704,Madea's Witness Protection,25390575,65653242,40262667,38.70,"2,161",11749,"Jun 29, 2012",Lionsgate
705,Gnomeo & Juliet,25356909,99967670,74610761,25.40,"2,994",8469,"Feb 11, 2011",Walt Disney Studios Motion Pictures
706,Apollo 13,25353380,172071312,146717932,14.70,"2,197",11540,"Jun 30, 1995",Universal Pictures
707,Indiana Jones and the Temple of Doom,25337110,179870271,154533161,14.10,"1,687",15019,"May 23, 1984",Paramount Pictures
708,Gone in 60 Seconds,25336048,101648571,76312523,24.90,"3,006",8428,"Jun 9, 2000",Walt Disney Studios Motion Pictures
709,Underworld Awakening,25306725,62321039,37014314,40.60,"3,078",8221,"Jan 20, 2012",Screen Gems
710,Public Enemies,25271675,97104620,71832945,26,"3,334",7579,"Jul 1, 2009",Universal Pictures
711,Patch Adams,25262280,135026902,109764622,18.70,"2,712",9315,"Dec 25, 1998",Universal Pictures
712,Date Night,25207599,98711404,73503805,25.50,"3,374",7471,"Apr 9, 2010",Twentieth Century Fox
713,Tomorrow Never Dies,25143007,125304276,100161269,20.10,"2,807",8957,"Dec 19, 1997",Metro-Goldwyn-Mayer (MGM)
714,Meet the Robinsons,25123781,97822171,72698390,25.70,"3,413",7361,"Mar 30, 2007",Walt Disney Studios Motion Pictures
715,Master and Commander: The Far Side of the World,25105990,93927920,68821930,26.70,"3,101",8096,"Nov 14, 2003",Twentieth Century Fox
716,The Rock,25069525,134069511,108999986,18.70,"2,392",10480,"Jun 7, 1996",Walt Disney Studios Motion Pictures
717,Madea's Big Happy Family,25068677,53345287,28276610,47,"2,288",10956,"Apr 22, 2011",Lionsgate
718,Dr. Dolittle 2,25037039,112952899,87915860,22.20,"3,049",8211,"Jun 22, 2001",Twentieth Century Fox
719,Vanilla Sky,25015518,100618344,75602826,24.90,"2,742",9123,"Dec 14, 2001",Paramount Pictures
720,Peter Rabbit,25010928,115253424,90242496,21.70,"3,725",6714,"Feb 9, 2018",Sony Pictures Releasing
721,Jack and Jill,25003575,74158157,49154582,33.70,"3,438",7272,"Nov 11, 2011",Sony Pictures Releasing
722,Skyscraper,24905015,68420120,43515105,36.40,"3,782",6585,"Jul 13, 2018",Universal Pictures
723,Flight,24900566,93772375,68871809,26.60,"1,884",13216,"Nov 2, 2012",Paramount Pictures
724,White House Down,24852258,73103784,48251526,34,"3,222",7713,"Jun 28, 2013",Sony Pictures Releasing
725,A Good Day to Die Hard,24834845,67349198,42514353,36.90,"3,553",6989,"Feb 14, 2013",Twentieth Century Fox
726,True Grit,24830443,171243005,146412562,14.50,"3,047",8149,"Dec 22, 2010",Paramount Pictures
727,The Call of the Wild,24791624,57806808,33015184,42.90,"3,752",6607,"Feb 21, 2020",Twentieth Century Fox
728,The Other Woman,24763752,83911193,59147441,29.50,"3,205",7726,"Apr 25, 2014",Twentieth Century Fox
729,Predators,24760882,52000688,27239806,47.60,"2,669",9277,"Jul 9, 2010",Twentieth Century Fox
730,Zombieland,24733155,75590286,50857131,32.70,"3,036",8146,"Oct 2, 2009",Sony Pictures Releasing
731,10 Cloverfield Lane,24727437,72082998,47355561,34.30,"3,391",7292,"Mar 11, 2016",Paramount Pictures
732,Taken,24717037,145000989,120283952,17,"3,183",7765,"Jan 30, 2009",Twentieth Century Fox
733,The Accountant,24710273,86260045,61549772,28.60,"3,332",7416,"Oct 14, 2016",Warner Bros.
734,Collateral,24701458,101005703,76304245,24.50,"3,188",7748,"Aug 6, 2004",DreamWorks Distribution
735,Congo,24642539,81022101,56379562,30.40,"2,649",9302,"Jun 9, 1995",Paramount Pictures
736,Lee Daniels' The Butler,24637312,116632095,91994783,21.10,"2,933",8400,"Aug 16, 2013",The Weinstein Company
737,The Predator,24632284,51024708,26392424,48.30,"4,037",6101,"Sep 14, 2018",Twentieth Century Fox
738,Flightplan,24629938,89707299,65077361,27.50,"3,424",7193,"Sep 23, 2005",Walt Disney Studios Motion Pictures
739,Knowing,24604751,79957634,55352883,30.80,"3,332",7384,"Mar 20, 2009",Summit Entertainment
740,Christopher Robin,24585139,99215042,74629903,24.80,"3,602",6825,"Aug 3, 2018",Walt Disney Studios Motion Pictures
741,Eraser,24566446,101295562,76729116,24.20,"2,410",10193,"Jun 21, 1996",Warner Bros.
742,The Girl on the Train,24536265,75395035,50858770,32.50,"3,144",7804,"Oct 7, 2016",Universal Pictures
743,The Emoji Movie,24531923,86089513,61557590,28.50,"4,075",6020,"Jul 28, 2017",Sony Pictures Releasing
744,Pet Sematary,24502775,54724696,30221921,44.80,"3,585",6834,"Apr 5, 2019",Paramount Pictures
745,Act of Valor,24476632,70012847,45536215,35,"3,039",8054,"Feb 24, 2012",Relativity Media
746,Forrest Gump,24450602,329694499,305243897,7.40,"1,595",15329,"Jul 6, 1994",Paramount Pictures
747,Mean Girls,24432195,86058055,61625860,28.40,"2,839",8605,"Apr 30, 2004",Paramount Pictures
748,Failure to Launch,24411322,88715192,64303870,27.50,"3,057",7985,"Mar 10, 2006",Paramount Pictures
749,Race to Witch Mountain,24402214,67172594,42770380,36.30,"3,187",7656,"Mar 13, 2009",Walt Disney Studios Motion Pictures
750,Contraband,24349815,66528000,42178185,36.60,"2,863",8505,"Jan 13, 2012",Universal Pictures
751,The Chronicles of Riddick,24289165,57761012,33471847,42,"2,757",8809,"Jun 11, 2004",Universal Pictures
752,The Haunted Mansion,24278410,75847266,51568856,32,"3,122",7776,"Nov 26, 2003",Walt Disney Studios Motion Pictures
753,The Last Samurai,24271354,111127263,86855909,21.80,"2,908",8346,"Dec 5, 2003",Warner Bros.
754,TMNT,24255205,54149098,29893893,44.80,"3,110",7799,"Mar 23, 2007",Warner Bros.
755,No Good Deed,24250283,52543632,28293349,46.20,"2,175",11149,"Sep 12, 2014",Screen Gems
756,Barbershop 2: Back in Business,24241612,65111277,40869665,37.20,"2,711",8941,"Feb 6, 2004",Metro-Goldwyn-Mayer (MGM)
757,"Me, Myself & Irene",24209385,90570999,66361614,26.70,"3,019",8019,"Jun 23, 2000",Twentieth Century Fox
758,The Addams Family,24203754,113502426,89298672,21.30,"2,411",10038,"Nov 22, 1991",Paramount Pictures
759,Coach Carter,24182961,67264877,43081916,36,"2,524",9581,"Jan 14, 2005",Paramount Pictures
760,Maze Runner: The Death Cure,24167011,58032443,33865432,41.60,"3,787",6381,"Jan 26, 2018",Twentieth Century Fox
761,Warcraft,24166110,47365290,23199180,51,"3,400",7107,"Jun 10, 2016",Universal Pictures
762,Con Air,24131738,101117573,76985835,23.90,"2,824",8545,"Jun 6, 1997",Walt Disney Studios Motion Pictures
763,Exodus: Gods and Kings,24115934,65014513,40898579,37.10,"3,503",6884,"Dec 12, 2014",Twentieth Century Fox
764,White Noise,24113565,56386759,32273194,42.80,"2,261",10665,"Jan 7, 2005",Universal Pictures
765,21,24105943,81159365,57053422,29.70,"2,648",9103,"Mar 28, 2008",Sony Pictures Releasing
766,Arrival,24074047,100546139,76472092,23.90,"2,317",10390,"Nov 11, 2016",Paramount Pictures
767,Tower Heist,24025190,78046570,54021380,30.80,"3,367",7135,"Nov 4, 2011",Universal Pictures
768,Pixels,24011616,78747585,54735969,30.50,"3,723",6449,"Jul 24, 2015",Sony Pictures Releasing
769,The Chronicles of Narnia: The Voyage of the Dawn Treader,24005069,104386950,80381881,23,"3,555",6752,"Dec 10, 2010",Twentieth Century Fox
770,Monster-in-Law,24000000,82931301,58931301,28.90,"3,424",7009,"May 13, 2005",New Line Cinema
771,The Fast and the Furious: Tokyo Drift,23973840,62514415,38540575,38.40,"3,027",7920,"Jun 16, 2006",Universal Pictures
772,Fahrenheit 9/11,23920637,119194771,95274134,20.10,868,27558,"Jun 23, 2004",Lionsgate
773,Captain Underpants: The First Epic Movie,23851539,73921000,50069461,32.30,"3,434",6945,"Jun 2, 2017",Twentieth Century Fox
774,Bad Moms,23817340,113257297,89439957,21,"3,215",7408,"Jul 29, 2016",STX Entertainment
775,The Town,23808032,92186262,68378230,25.80,"2,861",8321,"Sep 17, 2010",Warner Bros.
776,How to Lose a Guy in 10 Days,23774850,105813373,82038523,22.50,"2,923",8133,"Feb 7, 2003",Paramount Pictures
777,Rise of the Guardians,23773465,103412758,79639293,23,"3,653",6507,"Nov 21, 2012",DreamWorks
778,Paul Blart: Mall Cop 2,23762435,71038190,47275755,33.40,"3,633",6540,"Apr 17, 2015",Sony Pictures Releasing
779,The Fugitive,23758855,183875760,160116905,12.90,"2,340",10153,"Aug 6, 1993",Warner Bros.
780,Diary of a Wimpy Kid: Rodrick Rules,23751502,52698535,28947033,45.10,"3,167",7499,"Mar 25, 2011",Twentieth Century Fox
781,17 Again,23722310,64167069,40444759,37,"3,255",7287,"Apr 17, 2009",Warner Bros.
782,Fury,23702421,85817906,62115485,27.60,"3,173",7470,"Oct 17, 2014",Sony Pictures Releasing
783,Resident Evil: Extinction,23678580,50648679,26970099,46.80,"2,828",8372,"Sep 21, 2007",Screen Gems
784,Tomb Raider,23633317,58250803,34617486,40.60,"3,854",6132,"Mar 16, 2018",Warner Bros.
785,Open Season,23624548,85105259,61480711,27.80,"3,833",6163,"Sep 29, 2006",Sony Pictures Releasing
786,Goosebumps,23618556,80080379,56461823,29.50,"3,501",6746,"Oct 16, 2015",Sony Pictures Releasing
787,The Boss,23586645,63285885,39699240,37.30,"3,480",6777,"Apr 8, 2016",Universal Pictures
788,Dinner for Schmucks,23527839,73026337,49498498,32.20,"2,911",8082,"Jul 30, 2010",DreamWorks
789,Mary Poppins Returns,23523121,171958438,148435317,13.70,"4,090",5751,"Dec 19, 2018",Walt Disney Studios Motion Pictures
790,Dracula Untold,23514615,56280355,32765740,41.80,"2,885",8150,"Oct 10, 2014",Universal Pictures
791,The Amityville Horror,23507007,65233369,41726362,36,"3,323",7074,"Apr 15, 2005",Metro-Goldwyn-Mayer (MGM)
792,Be Cool,23450212,56046979,32596767,41.80,"3,216",7291,"Mar 4, 2005",Metro-Goldwyn-Mayer (MGM)
793,I Can Do Bad All by Myself,23446785,51733921,28287136,45.30,"2,255",10397,"Sep 11, 2009",Lionsgate
794,Save the Last Dance,23444930,91057006,67612076,25.80,"2,230",10513,"Jan 12, 2001",Paramount Pictures
795,Once Upon a Time in Mexico,23424118,56359780,32935662,41.60,"3,282",7137,"Sep 12, 2003",Sony Pictures Releasing
796,Face/Off,23387530,112276146,88888616,20.80,"2,621",8923,"Jun 27, 1997",Paramount Pictures
797,The Taking of Pelham 123,23373102,65452312,42079210,35.70,"3,074",7603,"Jun 12, 2009",Sony Pictures Releasing
798,The Polar Express,23323463,162775358,139451895,14.30,"3,650",6389,"Nov 10, 2004",Warner Bros.
799,Mortal Kombat,23283887,70454098,47170211,33,"2,421",9617,"Aug 18, 1995",New Line Cinema
800,Pineapple Express,23245025,87341380,64096355,26.60,"3,072",7566,"Aug 6, 2008",Sony Pictures Releasing
801,Alvin and the Chipmunks: Chipwrecked,23244744,133110742,109865998,17.50,"3,723",6243,"Dec 16, 2011",Twentieth Century Fox
802,Eragon,23239907,75030163,51790256,31,"3,020",7695,"Dec 15, 2006",Twentieth Century Fox
803,This Is It,23234394,72091016,48856622,32.20,"3,481",6674,"Oct 28, 2009",Sony Pictures Releasing
804,Hellboy,23172440,59623958,36451518,38.90,"3,028",7652,"Apr 2, 2004",Revolution Studios
805,Double Jeopardy,23162542,116741558,93579016,19.80,"2,547",9094,"Sep 24, 1999",Paramount Pictures
806,The Mask,23117068,119938730,96821662,19.30,"2,360",9795,"Jul 29, 1994",New Line Cinema
807,Star Trek: Generations,23116394,75671125,52554731,30.60,"2,659",8693,"Nov 18, 1994",Paramount Pictures
808,Eat Pray Love,23104523,80574010,57469487,28.70,"3,082",7496,"Aug 13, 2010",Sony Pictures Releasing
809,The League of Extraordinary Gentlemen,23075892,66465204,43389312,34.70,"3,002",7686,"Jul 11, 2003",Twentieth Century Fox
810,Smallfoot,23045635,83240103,60194468,27.70,"4,131",5578,"Sep 28, 2018",Warner Bros.
811,Resident Evil: Apocalypse,23036273,51201453,28165180,45,"3,284",7014,"Sep 10, 2004",Screen Gems
812,Star Wars: Episode VI - Return of the Jedi,23019618,252583617,229563999,9.10,"1,002",22973,"May 25, 1983",Twentieth Century Fox
813,27 Dresses,23007725,76808654,53800929,30,"3,057",7526,"Jan 18, 2008",Twentieth Century Fox
814,The Haunting in Connecticut2009 Re-release,23004765,55389516,32384751,41.50,"2,732",8420,"Mar 27, 2009",Lionsgate
815,The Princess Diaries 2: Royal Engagement,22956453,95170481,72214028,24.10,"3,472",6611,"Aug 11, 2004",Walt Disney Studios Motion Pictures
816,The Game Plan,22950971,90648202,67697231,25.30,"3,103",7396,"Sep 28, 2007",Walt Disney Studios Motion Pictures
817,Vantage Point,22874936,72266306,49391370,31.60,"3,149",7264,"Feb 22, 2008",Sony Pictures Releasing
818,Jack Reacher: Never Go Back,22872490,58697076,35824586,39,"3,780",6050,"Oct 21, 2016",Paramount Pictures
819,The Princess Diaries,22862269,108248956,85386687,21.10,"2,537",9011,"Aug 3, 2001",Walt Disney Studios Motion Pictures
820,Mission to Mars,22855247,60883407,38028160,37.50,"3,054",7483,"Mar 10, 2000",Walt Disney Studios Motion Pictures
821,The Interpreter,22822455,72708161,49885706,31.40,"2,758",8275,"Apr 22, 2005",Universal Pictures
822,Jackass: The Movie,22763437,64255312,41491875,35.40,"2,509",9072,"Oct 25, 2002",Paramount Pictures
823,Man on Fire,22751490,77911774,55160284,29.20,"2,980",7634,"Apr 21, 2004",Twentieth Century Fox
824,Mulan,22745143,120620254,97875111,18.90,"2,888",7875,"Jun 19, 1998",Walt Disney Studios Motion Pictures
825,Rugrats in Paris: The Movie,22718184,76507756,53789572,29.70,"2,934",7743,"Nov 17, 2000",Paramount Pictures
826,Insidious: Chapter 3,22692741,52218558,29525817,43.50,"3,002",7559,"Jun 5, 2015",Focus Features
827,Unstoppable,22688457,81562942,58874485,27.80,"3,207",7074,"Nov 12, 2010",Twentieth Century Fox
828,Funny People,22657780,51855045,29197265,43.70,"3,007",7535,"Jul 31, 2009",Universal Pictures
829,Black Mass,22635037,62575678,39940641,36.20,"3,188",7100,"Sep 18, 2015",Warner Bros.
830,Poltergeist,22620386,47425125,24804739,47.70,"3,240",6981,"May 22, 2015",Twentieth Century Fox
831,The Time Machine,22610437,56832494,34222057,39.80,"2,944",7680,"Mar 8, 2002",DreamWorks Distribution
832,Bridge to Terabithia,22564612,82272442,59707830,27.40,"3,139",7188,"Feb 16, 2007",Walt Disney Studios Motion Pictures
833,Training Day,22550788,76631907,54081119,29.40,"2,712",8315,"Oct 5, 2001",Warner Bros.
834,Dick Tracy,22543911,103738726,81194815,21.70,"2,332",9667,"Jun 15, 1990",Walt Disney Studios Motion Pictures
835,Saw: The Final Chapter,22530123,45710178,23180055,49.30,"2,808",8023,"Oct 29, 2010",Lionsgate
836,The Mask of Zorro,22525855,94095523,71569668,23.90,"2,515",8956,"Jul 17, 1998",Sony Pictures Releasing
837,Heaven Is for Real,22522221,91443253,68921032,24.60,"2,417",9318,"Apr 16, 2014",TriStar Pictures
838,The Lucky One,22518358,60457138,37938780,37.20,"3,155",7137,"Apr 20, 2012",Warner Bros.
839,Shallow Hal,22518295,70839203,48320908,31.80,"2,770",8129,"Nov 9, 2001",Twentieth Century Fox
840,Star Wars: Episode I - The Phantom Menace2012 3D Release,22469932,43456382,20986450,51.70,"2,655",8463,"Feb 10, 2012",Twentieth Century Fox
841,Life of Pi,22451514,124987023,102535509,18,"2,927",7670,"Nov 21, 2012",Twentieth Century Fox
842,The Social Network,22445653,96962694,74517041,23.20,"2,771",8100,"Oct 1, 2010",Sony Pictures Releasing
843,The Patriot,22413710,113330342,90916632,19.80,"3,061",7322,"Jun 28, 2000",Sony Pictures Releasing
844,Contagion,22403596,75658097,53254501,29.60,"3,222",6953,"Sep 9, 2011",Warner Bros.
845,Now You See Me 2,22383146,65075540,42692394,34.40,"3,232",6925,"Jun 10, 2016",Lionsgate
846,Walk the Line,22347341,119519402,97172061,18.70,"2,961",7547,"Nov 18, 2005",Twentieth Century Fox
847,The General's Daughter,22332053,102705852,80373799,21.70,"2,856",7819,"Jun 18, 1999",Paramount Pictures
848,Planes,22232291,90288712,68056421,24.60,"3,702",6005,"Aug 9, 2013",Walt Disney Studios Motion Pictures
849,Disturbia,22224982,80209692,57984710,27.70,"2,925",7598,"Apr 13, 2007",DreamWorks
850,"Legally Blonde 2: Red, White & Blonde",22220670,90186328,67965658,24.60,"3,350",6633,"Jul 2, 2003",Metro-Goldwyn-Mayer (MGM)
851,Monster House,22217226,73661010,51443784,30.20,"3,553",6253,"Jul 21, 2006",Sony Pictures Releasing
852,Freaky Friday,22203007,110230332,88027325,20.10,"2,954",7516,"Aug 6, 2003",Walt Disney Studios Motion Pictures
853,Kill Bill: Vol. 1,22200000,70099045,47899045,31.70,"3,102",7156,"Oct 10, 2003",Miramax
854,Die Hard with a Vengeance,22162245,100012499,77850254,22.20,"2,525",8777,"May 19, 1995",Twentieth Century Fox
855,Poseidon,22155410,60674817,38519407,36.50,"3,555",6232,"May 12, 2006",Warner Bros.
856,Diary of a Wimpy Kid,22126166,64003625,41877459,34.60,"3,077",7190,"Mar 19, 2010",Twentieth Century Fox
857,Ghost Rider: Spirit of Vengeance,22115334,51774002,29658668,42.70,"3,174",6967,"Feb 17, 2012",Sony Pictures Releasing
858,It's Complicated,22100820,112735375,90634555,19.60,"2,887",7655,"Dec 25, 2009",Universal Pictures
859,Ladder 49,22088204,74541707,52453503,29.60,"3,260",6775,"Oct 1, 2004",Walt Disney Studios Motion Pictures
860,Road to Perdition,22079481,104454762,82375281,21.10,"1,797",12286,"Jul 12, 2002",DreamWorks Distribution
861,Starship Troopers,22058773,54814377,32755604,40.20,"2,971",7424,"Nov 7, 1997",Sony Pictures Releasing
862,Star Trek: Insurrection,22052836,70187658,48134822,31.40,"2,620",8417,"Dec 11, 1998",Paramount Pictures
863,Chronicle,22004098,64575175,42571077,34.10,"2,907",7569,"Feb 3, 2012",Twentieth Century Fox
864,The Monuments Men,22003433,78031620,56028187,28.20,"3,083",7137,"Feb 7, 2014",Sony Pictures Releasing
865,Star Wars: Episode V - The Empire Strikes Back1997 Special Edition,21975993,67597694,45621701,32.50,"2,111",10410,"Feb 21, 1997",Twentieth Century Fox
866,Hide and Seek,21959233,51100486,29141253,43,"3,005",7307,"Jan 28, 2005",Twentieth Century Fox
867,Diary of a Mad Black Woman,21905089,50633099,28728010,43.30,"1,483",14770,"Feb 25, 2005",Lionsgate
868,Inspector Gadget,21889138,97403112,75513974,22.50,"2,814",7778,"Jul 23, 1999",Walt Disney Studios Motion Pictures
869,Unknown,21856389,63686397,41830008,34.30,"3,043",7182,"Feb 18, 2011",Warner Bros.
870,Dolittle,21844045,76859800,55015755,28.40,"4,155",5257,"Jan 17, 2020",Universal Pictures
871,Stomp the Yard,21833312,61356221,39522909,35.60,"2,051",10645,"Jan 12, 2007",Screen Gems
872,Notting Hill,21811180,116089678,94278498,18.80,"2,747",7940,"May 28, 1999",Universal Pictures
873,Lara Croft Tomb Raider: The Cradle of Life,21783641,65660196,43876555,33.20,"3,222",6760,"Jul 25, 2003",Paramount Pictures
874,RED,21761408,90380162,68618754,24.10,"3,255",6685,"Oct 15, 2010",Summit Entertainment
875,Neighbors 2: Sorority Rising,21760405,55455765,33695360,39.20,"3,384",6430,"May 20, 2016",Universal Pictures
876,Underworld,21753759,51970690,30216931,41.90,"2,915",7462,"Sep 19, 2003",Screen Gems
877,Die Hard 2,21744661,117540947,95796286,18.50,"2,507",8673,"Jul 6, 1990",Twentieth Century Fox
878,Texas Chainsaw 3D,21744470,34341945,12597475,63.30,"2,654",8193,"Jan 4, 2013",Lionsgate
879,Garfield,21727611,75369589,53641978,28.80,"3,094",7022,"Jun 11, 2004",Twentieth Century Fox
880,Shaft,21714757,70334258,48619501,30.90,"2,337",9291,"Jun 16, 2000",Paramount Pictures
881,Cats & Dogs,21707617,93385515,71677898,23.20,"3,040",7140,"Jul 4, 2001",Warner Bros.
882,Eyes Wide Shut,21706163,55691208,33985045,39,"2,411",9002,"Jul 16, 1999",Warner Bros.
883,Spy Game,21689125,62362560,40673435,34.80,"2,770",7830,"Nov 21, 2001",Universal Pictures
884,Lights Out,21688103,67268835,45580732,32.20,"2,818",7696,"Jul 22, 2016",Warner Bros.
885,RoboCop,21681430,58607007,36925577,37,"3,372",6429,"Feb 12, 2014",Sony Pictures Releasing
886,My Best Friend's Wedding,21678377,127120029,105441652,17,"2,134",10158,"Jun 20, 1997",Sony Pictures Releasing
887,Bumblebee,21654047,127195589,105541542,17,"3,550",6099,"Dec 21, 2018",Paramount Pictures
888,Temptation: Confessions of a Marriage Counselor,21641679,51975354,30333675,41.60,"2,047",10572,"Mar 29, 2013",Lionsgate
889,London Has Fallen,21635601,62524260,40888659,34.60,"3,490",6199,"Mar 4, 2016",Focus Features
890,Little Man,21613176,58645052,37031876,36.80,"2,533",8532,"Jul 14, 2006",Revolution Studios
891,When a Stranger Calls,21607203,47860214,26253011,45.20,"2,999",7204,"Feb 3, 2006",Screen Gems
892,Fool's Gold,21589295,70231041,48641746,30.70,"3,125",6908,"Feb 8, 2008",Warner Bros.
893,Tammy,21577049,84525432,62948383,25.50,"3,465",6227,"Jul 2, 2014",Warner Bros.
894,Christmas with the Kranks,21570867,73780539,52209672,29.20,"3,393",6357,"Nov 24, 2004",Revolution Studios
895,"You, Me and Dupree",21525560,75628110,54102550,28.50,"3,131",6874,"Jul 14, 2006",Universal Pictures
896,Pete's Dragon,21514095,76233151,54719056,28.20,"3,702",5811,"Aug 12, 2016",Walt Disney Studios Motion Pictures
897,American Reunion,21514080,57011521,35497441,37.70,"3,192",6740,"Apr 6, 2012",Universal Pictures
898,The 40-Year-Old Virgin,21422815,109449237,88026422,19.60,"2,845",7529,"Aug 19, 2005",Universal Pictures
899,The Stepford Wives,21406781,59484742,38077961,36,"3,057",7002,"Jun 11, 2004",Paramount Pictures
900,Good Boys,21402605,83140306,61737701,25.70,"3,204",6679,"Aug 16, 2019",Universal Pictures
901,Safe Haven,21401594,71349120,49947526,30,"3,223",6640,"Feb 14, 2013",Relativity Media
902,The Forbidden Kingdom,21401121,52075270,30674149,41.10,"3,151",6791,"Apr 18, 2008",Lionsgate
903,The Hitman's Bodyguard,21384504,75468583,54084079,28.30,"3,377",6332,"Aug 18, 2017",Lionsgate
904,Angel Has Fallen,21380987,69030436,47649449,31,"3,286",6506,"Aug 23, 2019",Lionsgate
905,Ice Age: Collision Course,21373064,64063008,42689944,33.40,"3,992",5353,"Jul 22, 2016",Twentieth Century Fox
906,Why Did I Get Married?,21353789,55204525,33850736,38.70,"2,011",10618,"Oct 12, 2007",Lionsgate
907,Turbo,21312625,83028128,61715503,25.70,"3,806",5599,"Jul 17, 2013",Twentieth Century Fox
908,Storks,21311407,72679278,51367871,29.30,"3,922",5433,"Sep 23, 2016",Warner Bros.
909,My Bloody Valentine,21241456,51545952,30304496,41.20,"2,534",8382,"Jan 16, 2009",Lionsgate
910,Happy Feet Two,21237068,64006466,42769398,33.20,"3,606",5889,"Nov 18, 2011",Warner Bros.
911,Boo 2! A Madea Halloween,21226953,47319572,26092619,44.90,"2,388",8889,"Oct 20, 2017",Lionsgate
912,Payback,21221526,81526121,60304595,26,"2,729",7776,"Feb 5, 1999",Paramount Pictures
913,Four Brothers,21176925,74494381,53317456,28.40,"2,533",8360,"Aug 12, 2005",Paramount Pictures
914,Waterworld,21171780,88246220,67074440,24,"2,268",9335,"Jul 28, 1995",Universal Pictures
915,The Adjustment Bureau,21157730,62495645,41337915,33.80,"2,840",7449,"Mar 4, 2011",Universal Pictures
916,The Hitchhiker's Guide to the Galaxy,21103203,51085416,29982213,41.30,"3,133",6735,"Apr 29, 2005",Walt Disney Studios Motion Pictures
917,Bride Wars,21058173,58715510,37657337,35.90,"3,226",6527,"Jan 9, 2009",Twentieth Century Fox
918,13 Going on 30,21054283,57231747,36177464,36.80,"3,438",6123,"Apr 23, 2004",Revolution Studios
919,Resident Evil: Retribution,21052227,42345531,21293304,49.70,"3,012",6989,"Sep 14, 2012",Screen Gems
920,Project X,21051363,54731865,33680502,38.50,"3,055",6890,"Mar 2, 2012",Warner Bros.
921,Law Abiding Citizen,21039502,73357727,52318225,28.70,"2,890",7280,"Oct 16, 2009",Overture Films
922,The Hunchback of Notre Dame,21037414,100138851,79101437,21,"2,778",7572,"Jun 21, 1996",Walt Disney Studios Motion Pictures
923,Valkyrie,21027007,83077833,62050826,25.30,"2,711",7756,"Dec 25, 2008",United Artists
924,The Forgotten,21022111,67133509,46111398,31.30,"3,104",6772,"Sep 24, 2004",Revolution Studios
925,Journey to the Center of the Earth,21018141,101704370,80686229,20.70,"2,811",7477,"Jul 11, 2008",Warner Bros.
926,The Strangers,20997985,52597610,31599625,39.90,"2,466",8514,"May 30, 2008",Rogue Pictures
927,Insomnia,20930169,67355513,46425344,31.10,"2,610",8019,"May 24, 2002",Warner Bros.
928,Scary Stories to Tell in the Dark,20915346,68947075,48031729,30.30,"3,135",6671,"Aug 9, 2019",Lionsgate
929,Remember the Titans,20905831,115654751,94748920,18.10,"1,865",11209,"Sep 29, 2000",Walt Disney Studios Motion Pictures
930,The Woman in Black,20874072,54333290,33459218,38.40,"2,855",7311,"Feb 3, 2012",CBS Films
931,Seabiscuit,20854735,120277854,99423119,17.30,"1,989",10485,"Jul 25, 2003",Universal Pictures
932,Underworld: Rise of the Lycans,20828511,45802315,24973804,45.50,"2,942",7079,"Jan 23, 2009",Screen Gems
933,The Grudge 2,20825300,39143839,18318539,53.20,"3,211",6485,"Oct 13, 2006",Sony Pictures Releasing
934,The Naked Gun 2½: The Smell of Fear,20817139,86930411,66113272,24,"2,378",8754,"Jun 28, 1991",Paramount Pictures
935,Prisoners,20817053,61002302,40185249,34.10,"3,260",6385,"Sep 20, 2013",Warner Bros.
936,Prom Night,20804941,43869350,23064409,47.40,"2,700",7705,"Apr 11, 2008",Screen Gems
937,Looper,20801552,66486205,45684653,31.30,"2,992",6952,"Sep 28, 2012",TriStar Pictures
938,This Is the End,20719162,101470202,80751040,20.40,"3,055",6782,"Jun 12, 2013",Sony Pictures Releasing
939,The Bounty Hunter,20686423,67061228,46374805,30.80,"3,074",6729,"Mar 19, 2010",Sony Pictures Releasing
940,Guess Who,20671446,68915888,48244442,30,"3,147",6568,"Mar 25, 2005",Sony Pictures Releasing
941,Step Up,20659573,65328121,44668548,31.60,"2,467",8374,"Aug 11, 2006",Walt Disney Studios Motion Pictures
942,The Wedding Ringer,20649306,64460211,43810905,32,"3,003",6876,"Jan 16, 2015",Screen Gems
943,Barbershop,20627433,75782105,55154672,27.20,"1,605",12851,"Sep 13, 2002",Metro-Goldwyn-Mayer (MGM)
944,1408,20617667,71985628,51367961,28.60,"2,678",7698,"Jun 22, 2007",-
945,Abominable,20612100,60716390,40104290,34,"4,242",4859,"Sep 27, 2019",Universal Pictures
946,Contact,20584908,100920329,80335421,20.40,"1,923",10704,"Jul 11, 1997",Warner Bros.
947,Deja Vu,20574802,64038616,43463814,32.10,"3,108",6619,"Nov 22, 2006",Walt Disney Studios Motion Pictures
948,Blockers,20556350,60311495,39755145,34.10,"3,379",6083,"Apr 6, 2018",Universal Pictures
949,Baby Driver,20553320,107825862,87272542,19.10,"3,226",6371,"Jun 28, 2017",TriStar Pictures
950,Gemini Man,20552372,48546770,27994398,42.30,"3,642",5643,"Oct 11, 2019",Paramount Pictures
951,End of Days,20523595,66889043,46365448,30.70,"2,593",7915,"Nov 24, 1999",Universal Pictures
952,Takers,20512304,57744720,37232416,35.50,"2,206",9298,"Aug 27, 2010",Screen Gems
953,Scary Movie 2,20503356,71308997,50805641,28.80,"3,220",6367,"Jul 4, 2001",Miramax
954,Notorious,20497596,36843682,16346086,55.60,"1,638",12513,"Jan 16, 2009",Fox Searchlight Pictures
955,Mrs. Doubtfire,20468847,219195243,198726396,9.30,"1,605",12753,"Nov 24, 1993",Twentieth Century Fox
956,The Lego Ninjago Movie,20433071,59281555,38848484,34.50,"4,047",5048,"Sep 22, 2017",Warner Bros.
957,Life,20414775,64016268,43601493,31.90,"2,594",7869,"Apr 16, 1999",Universal Pictures
958,Lethal Weapon 2,20388800,147253986,126865186,13.80,"1,803",11308,"Jul 7, 1989",Warner Bros.
959,Legally Blonde,20377426,96520674,76143248,21.10,"2,620",7777,"Jul 13, 2001",Metro-Goldwyn-Mayer (MGM)
960,The Last Exorcism,20366613,41034350,20667737,49.60,"2,874",7086,"Aug 27, 2010",Lionsgate
961,The Upside,20355000,108252517,87897517,18.80,"3,080",6608,"Jan 11, 2019",STX Entertainment
962,Warm Bodies,20353967,66380662,46026695,30.70,"3,009",6764,"Feb 1, 2013",Lionsgate
963,The Nutcracker and the Four Realms,20352491,54858851,34506360,37.10,"3,766",5404,"Nov 2, 2018",Walt Disney Studios Motion Pictures
964,Clear and Present Danger,20348017,122187717,101839700,16.60,"2,378",8556,"Aug 5, 1994",Paramount Pictures
965,John Q,20275194,71756802,51481608,28.30,"2,466",8221,"Feb 15, 2002",New Line Cinema
966,Annabelle Comes Home,20269723,74152591,53882868,27.30,"3,613",5610,"Jun 26, 2019",Warner Bros.
967,Friday Night Lights,20269025,61255921,40986896,33.10,"2,667",7599,"Oct 8, 2004",Universal Pictures
968,Pain & Gain,20244505,49875291,29630786,40.60,"3,277",6177,"Apr 26, 2013",Paramount Pictures
969,Barbershop: The Next Cut,20242415,54030051,33787636,37.50,"2,661",7607,"Apr 15, 2016",Warner Bros.
970,Deepwater Horizon,20223544,61433527,41209983,32.90,"3,259",6205,"Sep 30, 2016",Lionsgate
971,The Pink Panther,20220412,82226474,62006062,24.60,"3,477",5815,"Feb 10, 2006",Sony Pictures Releasing
972,We Were Soldiers,20212543,78122718,57910175,25.90,"3,143",6430,"Mar 1, 2002",Paramount Pictures
973,Eight Below,20188176,81612565,61424389,24.70,"3,066",6584,"Feb 17, 2006",Walt Disney Studios Motion Pictures
974,Rambo: First Blood Part II,20176217,150415432,130239215,13.40,"2,074",9728,"May 22, 1985",TriStar Pictures
975,What Happens in Vegas,20172474,80277646,60105172,25.10,"3,215",6274,"May 9, 2008",Twentieth Century Fox
976,Kicking & Screaming,20159925,52842724,32682799,38.20,"3,455",5835,"May 13, 2005",Universal Pictures
977,Lost in Space,20154919,69117629,48962710,29.20,"3,306",6096,"Apr 3, 1998",New Line Cinema
978,Silent Hill,20152598,46982632,26830034,42.90,"2,926",6887,"Apr 21, 2006",Sony Pictures Releasing
979,Entrapment,20145595,87704396,67558801,23,"2,814",7159,"Apr 30, 1999",Twentieth Century Fox
980,Knight and Day2010 Re-release,20139985,76423035,56283050,26.40,"3,098",6500,"Jun 23, 2010",Twentieth Century Fox
981,Bewitched,20131130,63313159,43182029,31.80,"3,174",6342,"Jun 24, 2005",Sony Pictures Releasing
982,xXx: Return of Xander Cage,20130142,44898413,24768271,44.80,"3,651",5513,"Jan 20, 2017",Paramount Pictures
983,Final Destination 3,20125000,54098051,33973051,37.20,"2,880",6987,"Feb 10, 2006",New Line Cinema
984,Beavis and Butt-Head Do America,20114233,63118386,43004153,31.90,"2,190",9184,"Dec 20, 1996",Paramount Pictures
985,The Mexican,20108829,66845033,46736204,30.10,"2,951",6814,"Mar 2, 2001",DreamWorks Distribution
986,Meet the Browns,20082809,41975388,21892579,47.80,"2,006",10011,"Mar 21, 2008",Lionsgate
987,Zookeeper,20065617,80360843,60295226,25,"3,482",5762,"Jul 8, 2011",Sony Pictures Releasing
988,Ray,20039730,75331600,55291870,26.60,"2,006",9989,"Oct 29, 2004",Universal Pictures
989,Enemy of the State,20038573,111549836,91511263,18,"2,393",8373,"Nov 20, 1998",Walt Disney Studios Motion Pictures
990,Teenage Mutant Ninja Turtles II: The Secret of the Ooze,20030473,78656813,58626340,25.50,"2,868",6984,"Mar 22, 1991",New Line Cinema
991,Julie & Julia,20027956,94125426,74097470,21.30,"2,354",8508,"Aug 7, 2009",Sony Pictures Releasing
992,The Manchurian Candidate,20018620,65955630,45937010,30.40,"2,867",6982,"Jul 30, 2004",Paramount Pictures
993,Rocky IV,19991537,127873716,107882179,15.60,"1,325",15087,"Nov 27, 1985",United Artists
994,Pitch Perfect 3,19928525,104897530,84969005,19,"3,447",5781,"Dec 22, 2017",Universal Pictures
995,102 Dalmatians,19883351,66957026,47073675,29.70,"2,704",7353,"Nov 22, 2000",Walt Disney Studios Motion Pictures
996,Ouija,19875995,50856010,30980015,39.10,"2,858",6954,"Oct 24, 2014",Universal Pictures
997,Kick-Ass,19828687,48071303,28242616,41.20,"3,065",6469,"Apr 16, 2010",Lionsgate
998,The Unborn,19810585,42670410,22859825,46.40,"2,357",8405,"Jan 9, 2009",Universal Pictures
999,The Cable Guy,19806226,60240295,40434069,32.90,"2,657",7454,"Jun 14, 1996",Sony Pictures Releasing
"1,000",Spawn,19738749,54870175,35131426,36,"2,536",7783,"Aug 1, 1997",New Line Cinema
,,,,0,,,,,